date_monday,year_iso,week_iso_num,geo_level,geo_code,geo_name,couv_dose1,couv_dose2,couv_rappel,n_dose1,n_complet,n_rappel,n_cum_dose1,n_cum_complet,n_cum_rappel,topic
2020-12-22,2020,52,REG,01,Guadeloupe,0.0,0.0,0.0,0,0,0,0,0,0,VACSI
2020-12-29,2020,53,REG,01,Guadeloupe,0.0,0.0,0.0,4,0,0,4,0,0,VACSI
2021-01-05,2021,1,REG,01,Guadeloupe,0.0,0.0,0.0,147,2,0,151,2,0,VACSI
2021-01-12,2021,2,REG,01,Guadeloupe,0.1,0.0,0.0,299,4,0,450,6,0,VACSI
2021-01-19,2021,3,REG,01,Guadeloupe,0.3,0.0,0.0,736,3,0,1186,9,0,VACSI
2021-01-26,2021,4,REG,01,Guadeloupe,0.6,0.0,0.0,1024,13,0,2210,22,0,VACSI
2021-02-02,2021,5,REG,01,Guadeloupe,1.0,0.0,0.0,1168,114,0,3378,136,0,VACSI
2021-02-09,2021,6,REG,01,Guadeloupe,1.3,0.1,0.0,1106,257,0,4484,393,0,VACSI
2021-02-16,2021,7,REG,01,Guadeloupe,1.5,0.1,0.0,671,115,0,5155,508,0,VACSI
2021-02-23,2021,8,REG,01,Guadeloupe,1.9,0.3,0.0,1294,424,0,6449,932,0,VACSI
2021-03-02,2021,9,REG,01,Guadeloupe,2.3,0.4,0.0,2047,546,0,8496,1478,0,VACSI
2021-03-09,2021,10,REG,01,Guadeloupe,3.0,0.6,0.0,1948,571,0,10444,2049,0,VACSI
2021-03-16,2021,11,REG,01,Guadeloupe,3.8,0.7,0.0,2526,426,0,12970,2475,0,VACSI
2021-03-23,2021,12,REG,01,Guadeloupe,4.7,0.9,0.0,3011,645,0,15981,3120,0,VACSI
2021-03-30,2021,13,REG,01,Guadeloupe,5.4,1.1,0.0,1924,553,0,17905,3673,0,VACSI
2021-04-06,2021,14,REG,01,Guadeloupe,6.1,1.3,0.0,2403,911,0,20308,4584,0,VACSI
2021-04-13,2021,15,REG,01,Guadeloupe,6.8,1.7,0.0,2691,1321,0,22999,5905,0,VACSI
2021-04-20,2021,16,REG,01,Guadeloupe,7.9,2.2,0.0,4740,1533,0,27739,7438,0,VACSI
2021-04-27,2021,17,REG,01,Guadeloupe,9.7,2.5,0.0,5711,1177,0,33450,8615,0,VACSI
2021-05-04,2021,18,REG,01,Guadeloupe,11.5,2.9,0.0,5468,1205,0,38918,9820,0,VACSI
2021-05-11,2021,19,REG,01,Guadeloupe,12.8,3.3,0.0,4270,1283,0,43188,11103,0,VACSI
2021-05-18,2021,20,REG,01,Guadeloupe,14.1,3.9,0.0,3918,2096,0,47106,13199,0,VACSI
2021-05-25,2021,21,REG,01,Guadeloupe,15.0,4.6,0.0,2594,2527,0,49700,15726,0,VACSI
2021-06-01,2021,22,REG,01,Guadeloupe,16.0,5.6,0.0,3474,4487,0,53174,20213,0,VACSI
2021-06-08,2021,23,REG,01,Guadeloupe,16.9,7.3,0.0,2880,7898,0,56054,28111,0,VACSI
2021-06-15,2021,24,REG,01,Guadeloupe,17.7,10.2,0.0,2727,6433,0,58781,34544,0,VACSI
2021-06-22,2021,25,REG,01,Guadeloupe,18.5,11.5,0.0,2365,4391,0,61146,38935,0,VACSI
2021-06-29,2021,26,REG,01,Guadeloupe,19.2,12.8,0.0,2461,4085,0,63607,43020,0,VACSI
2021-07-06,2021,27,REG,01,Guadeloupe,20.0,14.1,0.0,2578,4077,0,66185,47097,0,VACSI
2021-07-13,2021,28,REG,01,Guadeloupe,21.2,15.3,0.0,4689,4131,0,70874,51228,0,VACSI
2021-07-20,2021,29,REG,01,Guadeloupe,22.8,16.5,0.0,4989,4034,0,75863,55262,0,VACSI
2021-07-27,2021,30,REG,01,Guadeloupe,24.4,17.7,0.0,5700,3677,0,81563,58939,0,VACSI
2021-08-03,2021,31,REG,01,Guadeloupe,25.9,18.8,0.0,4598,3830,0,86161,62769,0,VACSI
2021-08-10,2021,32,REG,01,Guadeloupe,27.5,20.1,0.0,5750,4614,0,91911,67383,0,VACSI
2021-08-17,2021,33,REG,01,Guadeloupe,29.7,21.8,0.0,7242,5347,0,99153,72730,0,VACSI
2021-08-24,2021,34,REG,01,Guadeloupe,32.1,23.3,0.0,7818,5276,22,106971,78006,22,VACSI
2021-08-31,2021,35,REG,01,Guadeloupe,34.2,25.0,0.1,6099,5494,216,113070,83500,238,VACSI
2021-09-07,2021,36,REG,01,Guadeloupe,35.5,26.8,0.1,3864,5974,281,116934,89474,519,VACSI
2021-09-14,2021,37,REG,01,Guadeloupe,36.5,28.9,0.3,2898,7305,389,119832,96779,908,VACSI
2021-09-21,2021,38,REG,01,Guadeloupe,37.1,31.1,0.4,2218,6697,419,122050,103476,1327,VACSI
2021-09-28,2021,39,REG,01,Guadeloupe,37.8,32.7,0.5,2277,4630,429,124327,108106,1756,VACSI
2021-10-05,2021,40,REG,01,Guadeloupe,38.5,33.9,0.7,2364,3721,526,126691,111827,2282,VACSI
2021-10-12,2021,41,REG,01,Guadeloupe,39.3,34.9,0.8,2256,2925,569,128947,114752,2851,VACSI
2021-10-19,2021,42,REG,01,Guadeloupe,39.8,35.6,1.0,1685,2329,561,130632,117081,3412,VACSI
2021-10-26,2021,43,REG,01,Guadeloupe,40.3,36.3,1.2,1469,2146,700,132101,119227,4112,VACSI
2021-11-02,2021,44,REG,01,Guadeloupe,40.7,37.0,1.4,1472,2302,743,133573,121529,4855,VACSI
2021-11-09,2021,45,REG,01,Guadeloupe,41.2,37.6,1.8,1411,1916,1319,134984,123445,6174,VACSI
2021-11-16,2021,46,REG,01,Guadeloupe,41.5,38.1,2.2,884,1349,1041,135868,124794,7215,VACSI
2021-11-23,2021,47,REG,01,Guadeloupe,41.7,38.4,2.6,588,1111,2090,136456,125905,9305,VACSI
2021-11-30,2021,48,REG,01,Guadeloupe,41.9,38.9,4.1,792,1740,5772,137248,127645,15077,VACSI
2021-12-07,2021,49,REG,01,Guadeloupe,42.2,39.5,6.3,940,1807,7015,138188,129452,22092,VACSI
2021-12-14,2021,50,REG,01,Guadeloupe,42.5,39.9,8.3,921,1460,7057,139109,130912,29149,VACSI
2021-12-21,2021,51,REG,01,Guadeloupe,42.7,40.3,9.9,746,889,4241,139855,131801,33390,VACSI
2021-12-28,2021,52,REG,01,Guadeloupe,43.0,40.6,11.4,903,991,4822,140758,132792,38212,VACSI
2022-01-04,2022,1,REG,01,Guadeloupe,43.3,40.9,13.5,1111,1319,7827,141869,134111,46039,VACSI
2022-01-11,2022,2,REG,01,Guadeloupe,43.7,41.3,15.8,1077,1211,7383,142946,135322,53422,VACSI
2022-01-18,2022,3,REG,01,Guadeloupe,43.9,41.6,17.5,816,1021,4785,143762,136343,58207,VACSI
2022-01-25,2022,4,REG,01,Guadeloupe,44.0,41.8,18.0,115,167,614,143877,136510,58821,VACSI
2020-12-22,2020,52,REG,02,Martinique,0.0,0.0,0.0,0,0,0,0,0,0,VACSI
2020-12-29,2020,53,REG,02,Martinique,0.0,0.0,0.0,3,0,0,3,0,0,VACSI
2021-01-05,2021,1,REG,02,Martinique,0.0,0.0,0.0,273,1,0,276,1,0,VACSI
2021-01-12,2021,2,REG,02,Martinique,0.2,0.0,0.0,568,8,0,844,9,0,VACSI
2021-01-19,2021,3,REG,02,Martinique,0.5,0.0,0.0,782,5,0,1626,14,0,VACSI
2021-01-26,2021,4,REG,02,Martinique,0.7,0.0,0.0,675,138,0,2301,152,0,VACSI
2021-02-02,2021,5,REG,02,Martinique,0.9,0.1,0.0,620,383,0,2921,535,0,VACSI
2021-02-09,2021,6,REG,02,Martinique,1.1,0.3,0.0,597,395,0,3518,930,0,VACSI
2021-02-16,2021,7,REG,02,Martinique,1.2,0.4,0.0,261,332,0,3779,1262,0,VACSI
2021-02-23,2021,8,REG,02,Martinique,1.3,0.6,0.0,568,771,0,4347,2033,0,VACSI
2021-03-02,2021,9,REG,02,Martinique,1.6,0.8,0.0,1020,526,0,5367,2559,0,VACSI
2021-03-09,2021,10,REG,02,Martinique,2.1,0.9,0.0,1694,433,0,7061,2992,0,VACSI
2021-03-16,2021,11,REG,02,Martinique,2.7,1.0,0.0,1912,318,0,8973,3310,0,VACSI
2021-03-23,2021,12,REG,02,Martinique,3.4,1.2,0.0,2376,576,0,11349,3886,0,VACSI
2021-03-30,2021,13,REG,02,Martinique,4.6,1.4,0.0,5350,657,0,16699,4543,0,VACSI
2021-04-06,2021,14,REG,02,Martinique,6.7,1.7,0.0,6605,1387,0,23304,5930,0,VACSI
2021-04-13,2021,15,REG,02,Martinique,8.5,2.2,0.0,4975,1664,0,28279,7594,0,VACSI
2021-04-20,2021,16,REG,02,Martinique,9.9,2.8,0.0,3889,2160,0,32168,9754,0,VACSI
2021-04-27,2021,17,REG,02,Martinique,10.9,3.9,0.0,3305,3856,0,35473,13610,0,VACSI
2021-05-04,2021,18,REG,02,Martinique,11.9,5.3,0.0,3084,4852,0,38557,18462,0,VACSI
2021-05-11,2021,19,REG,02,Martinique,12.7,6.7,0.0,2471,4511,0,41028,22973,0,VACSI
2021-05-18,2021,20,REG,02,Martinique,13.6,8.0,0.0,2484,3205,0,43512,26178,0,VACSI
2021-05-25,2021,21,REG,02,Martinique,14.2,9.1,0.0,1821,3880,0,45333,30058,0,VACSI
2021-06-01,2021,22,REG,02,Martinique,14.7,10.2,0.0,1921,3184,0,47254,33242,0,VACSI
2021-06-08,2021,23,REG,02,Martinique,15.4,11.2,0.0,1950,3069,0,49204,36311,0,VACSI
2021-06-15,2021,24,REG,02,Martinique,16.1,12.1,0.0,2305,2735,0,51509,39046,0,VACSI
2021-06-22,2021,25,REG,02,Martinique,16.7,12.9,0.0,1968,2471,0,53477,41517,0,VACSI
2021-06-29,2021,26,REG,02,Martinique,17.3,13.6,0.0,1974,2125,0,55451,43642,0,VACSI
2021-07-06,2021,27,REG,02,Martinique,18.2,14.4,0.0,3415,2876,0,58866,46518,0,VACSI
2021-07-13,2021,28,REG,02,Martinique,20.0,15.3,0.0,6592,3006,0,65458,49524,0,VACSI
2021-07-20,2021,29,REG,02,Martinique,21.9,16.3,0.0,5126,2838,0,70584,52362,0,VACSI
2021-07-27,2021,30,REG,02,Martinique,23.4,17.2,0.0,4980,3309,0,75564,55671,0,VACSI
2021-08-03,2021,31,REG,02,Martinique,25.1,18.5,0.0,5670,4398,0,81234,60069,0,VACSI
2021-08-10,2021,32,REG,02,Martinique,27.3,20.1,0.0,7371,4879,0,88605,64948,0,VACSI
2021-08-17,2021,33,REG,02,Martinique,29.6,21.8,0.0,7072,5727,0,95677,70675,0,VACSI
2021-08-24,2021,34,REG,02,Martinique,31.9,23.5,0.0,7135,5667,17,102812,76342,17,VACSI
2021-08-31,2021,35,REG,02,Martinique,33.7,25.7,0.0,5082,6932,171,107894,83274,188,VACSI
2021-09-07,2021,36,REG,02,Martinique,34.9,27.7,0.1,3666,6613,378,111560,89887,566,VACSI
2021-09-14,2021,37,REG,02,Martinique,35.9,29.9,0.3,2957,6663,386,114517,96550,952,VACSI
2021-09-21,2021,38,REG,02,Martinique,36.8,31.7,0.4,2439,5506,356,116956,102056,1308,VACSI
2021-09-28,2021,39,REG,02,Martinique,37.6,33.1,0.5,2759,4007,445,119715,106063,1753,VACSI
2021-10-05,2021,40,REG,02,Martinique,38.4,34.3,0.7,2772,3422,683,122487,109485,2436,VACSI
2021-10-12,2021,41,REG,02,Martinique,39.3,35.2,0.9,2796,2936,668,125283,112421,3104,VACSI
2021-10-19,2021,42,REG,02,Martinique,40.1,36.1,1.2,2395,2784,785,127678,115205,3889,VACSI
2021-10-26,2021,43,REG,02,Martinique,40.8,37.0,1.4,1712,2322,746,129390,117527,4635,VACSI
2021-11-02,2021,44,REG,02,Martinique,41.3,37.7,1.7,1697,2564,1111,131087,120091,5746,VACSI
2021-11-09,2021,45,REG,02,Martinique,41.7,38.5,2.2,1375,2345,1730,132462,122436,7476,VACSI
2021-11-16,2021,46,REG,02,Martinique,42.2,39.2,2.8,1303,2092,2114,133765,124528,9590,VACSI
2021-11-23,2021,47,REG,02,Martinique,42.4,39.6,3.5,636,1179,2835,134401,125707,12425,VACSI
2021-11-30,2021,48,REG,02,Martinique,42.6,40.0,5.0,837,1617,6396,135238,127324,18821,VACSI
2021-12-07,2021,49,REG,02,Martinique,43.0,40.6,7.8,1279,1770,8190,136517,129094,27011,VACSI
2021-12-14,2021,50,REG,02,Martinique,43.4,41.1,9.9,1311,1337,6414,137828,130431,33425,VACSI
2021-12-21,2021,51,REG,02,Martinique,43.9,41.5,11.5,1315,1047,4100,139143,131478,37525,VACSI
2021-12-28,2021,52,REG,02,Martinique,44.3,41.8,13.0,1304,1133,5071,140447,132611,42596,VACSI
2022-01-04,2022,1,REG,02,Martinique,44.7,42.3,15.3,1573,1608,8366,142020,134219,50962,VACSI
2022-01-11,2022,2,REG,02,Martinique,45.2,42.8,17.9,1349,1620,7592,143369,135839,58554,VACSI
2022-01-18,2022,3,REG,02,Martinique,45.5,43.2,19.5,884,1276,4400,144253,137115,62954,VACSI
2022-01-25,2022,4,REG,02,Martinique,45.6,43.4,20.1,125,202,569,144378,137317,63523,VACSI
2020-12-22,2020,52,REG,03,Guyane,0.0,0.0,0.0,0,0,0,0,0,0,VACSI
2020-12-29,2020,53,REG,03,Guyane,0.0,0.0,0.0,7,1,0,7,1,0,VACSI
2021-01-05,2021,1,REG,03,Guyane,0.0,0.0,0.0,5,0,0,12,1,0,VACSI
2021-01-12,2021,2,REG,03,Guyane,0.1,0.0,0.0,198,1,0,210,2,0,VACSI
2021-01-19,2021,3,REG,03,Guyane,0.3,0.0,0.0,507,2,0,717,4,0,VACSI
2021-01-26,2021,4,REG,03,Guyane,0.5,0.0,0.0,433,6,0,1150,10,0,VACSI
2021-02-02,2021,5,REG,03,Guyane,0.7,0.0,0.0,410,51,0,1560,61,0,VACSI
2021-02-09,2021,6,REG,03,Guyane,0.9,0.1,0.0,391,289,0,1951,350,0,VACSI
2021-02-16,2021,7,REG,03,Guyane,1.1,0.3,0.0,535,397,0,2486,747,0,VACSI
2021-02-23,2021,8,REG,03,Guyane,1.5,0.5,0.0,1074,457,0,3560,1204,0,VACSI
2021-03-02,2021,9,REG,03,Guyane,2.1,0.7,0.0,1282,395,0,4842,1599,0,VACSI
2021-03-09,2021,10,REG,03,Guyane,2.8,0.9,0.0,1445,415,0,6287,2014,0,VACSI
2021-03-16,2021,11,REG,03,Guyane,3.4,1.2,0.0,1546,635,0,7833,2649,0,VACSI
2021-03-23,2021,12,REG,03,Guyane,4.0,1.6,0.0,1046,1116,0,8879,3765,0,VACSI
2021-03-30,2021,13,REG,03,Guyane,4.8,2.2,0.0,1704,1097,0,10583,4862,0,VACSI
2021-04-06,2021,14,REG,03,Guyane,5.7,2.8,0.0,2471,1441,0,13054,6303,0,VACSI
2021-04-13,2021,15,REG,03,Guyane,7.3,3.4,0.0,4311,1446,0,17365,7749,0,VACSI
2021-04-20,2021,16,REG,03,Guyane,9.3,4.0,0.0,4479,1266,0,21844,9015,0,VACSI
2021-04-27,2021,17,REG,03,Guyane,11.3,4.7,0.0,3818,1574,0,25662,10589,0,VACSI
2021-05-04,2021,18,REG,03,Guyane,12.9,5.6,0.0,3138,2248,0,28800,12837,0,VACSI
2021-05-11,2021,19,REG,03,Guyane,14.0,6.7,0.0,2388,2710,0,31188,15547,0,VACSI
2021-05-18,2021,20,REG,03,Guyane,15.3,8.1,0.0,2958,3076,0,34146,18623,0,VACSI
2021-05-25,2021,21,REG,03,Guyane,16.7,9.6,0.0,2628,3376,0,36774,21999,0,VACSI
2021-06-01,2021,22,REG,03,Guyane,18.0,11.0,0.0,3055,2617,0,39829,24616,0,VACSI
2021-06-08,2021,23,REG,03,Guyane,19.3,12.0,0.0,2692,2217,0,42521,26833,0,VACSI
2021-06-15,2021,24,REG,03,Guyane,20.5,13.2,0.0,2444,2842,0,44965,29675,0,VACSI
2021-06-22,2021,25,REG,03,Guyane,21.5,14.6,0.0,2209,2889,0,47174,32564,0,VACSI
2021-06-29,2021,26,REG,03,Guyane,22.6,16.0,0.0,2453,2968,0,49627,35532,0,VACSI
2021-07-06,2021,27,REG,03,Guyane,23.6,17.1,0.0,2231,2449,0,51858,37981,0,VACSI
2021-07-13,2021,28,REG,03,Guyane,25.0,18.3,0.0,3441,2544,0,55299,40525,0,VACSI
2021-07-20,2021,29,REG,03,Guyane,26.7,19.5,0.0,3512,2453,0,58811,42978,0,VACSI
2021-07-27,2021,30,REG,03,Guyane,28.2,20.6,0.0,3103,2324,0,61914,45302,0,VACSI
2021-08-03,2021,31,REG,03,Guyane,29.4,21.7,0.0,2398,2623,0,64312,47925,0,VACSI
2021-08-10,2021,32,REG,03,Guyane,30.7,23.1,0.0,2782,2967,0,67094,50892,0,VACSI
2021-08-17,2021,33,REG,03,Guyane,31.7,24.3,0.0,2156,2659,0,69250,53551,0,VACSI
2021-08-24,2021,34,REG,03,Guyane,32.6,25.6,0.0,1905,2726,14,71155,56277,14,VACSI
2021-08-31,2021,35,REG,03,Guyane,33.6,26.8,0.0,1962,2263,80,73117,58540,94,VACSI
2021-09-07,2021,36,REG,03,Guyane,34.3,27.7,0.1,1678,2089,97,74795,60629,191,VACSI
2021-09-14,2021,37,REG,03,Guyane,35.1,28.6,0.1,1598,1877,51,76393,62506,242,VACSI
2021-09-21,2021,38,REG,03,Guyane,35.8,29.5,0.2,1353,1803,111,77746,64309,353,VACSI
2021-09-28,2021,39,REG,03,Guyane,36.4,30.2,0.2,1551,1581,127,79297,65890,480,VACSI
2021-10-05,2021,40,REG,03,Guyane,37.1,30.8,0.3,1389,1300,143,80686,67190,623,VACSI
2021-10-12,2021,41,REG,03,Guyane,37.7,31.5,0.3,1296,1439,173,81982,68629,796,VACSI
2021-10-19,2021,42,REG,03,Guyane,38.3,32.1,0.5,1110,1318,259,83092,69947,1055,VACSI
2021-10-26,2021,43,REG,03,Guyane,38.8,32.8,0.6,1145,1252,255,84237,71199,1310,VACSI
2021-11-02,2021,44,REG,03,Guyane,39.3,33.4,0.7,1203,1411,336,85440,72610,1646,VACSI
2021-11-09,2021,45,REG,03,Guyane,39.8,33.9,0.9,995,1186,498,86435,73796,2144,VACSI
2021-11-16,2021,46,REG,03,Guyane,40.3,34.5,1.2,1053,1330,745,87488,75126,2889,VACSI
2021-11-23,2021,47,REG,03,Guyane,40.8,35.2,1.8,905,1328,1815,88393,76454,4704,VACSI
2021-11-30,2021,48,REG,03,Guyane,41.1,35.7,3.3,692,1160,3275,89085,77614,7979,VACSI
2021-12-07,2021,49,REG,03,Guyane,41.4,36.2,4.8,614,1181,3293,89699,78795,11272,VACSI
2021-12-14,2021,50,REG,03,Guyane,41.7,36.8,6.4,680,1154,3585,90379,79949,14857,VACSI
2021-12-21,2021,51,REG,03,Guyane,41.9,37.2,7.7,468,747,2262,90847,80696,17119,VACSI
2021-12-28,2021,52,REG,03,Guyane,42.2,37.5,8.8,553,505,2494,91400,81201,19613,VACSI
2022-01-04,2022,1,REG,03,Guyane,42.5,37.8,10.3,791,817,4005,92191,82018,23618,VACSI
2022-01-11,2022,2,REG,03,Guyane,42.8,38.2,12.3,704,793,4122,92895,82811,27740,VACSI
2022-01-18,2022,3,REG,03,Guyane,43.1,38.5,13.6,655,702,2396,93550,83513,30136,VACSI
2022-01-25,2022,4,REG,03,Guyane,43.3,38.6,14.0,76,109,233,93626,83622,30369,VACSI
2020-12-22,2020,52,REG,04,La Réunion,0.0,0.0,0.0,0,0,0,0,0,0,VACSI
2020-12-29,2020,53,REG,04,La Réunion,0.0,0.0,0.0,5,0,0,5,0,0,VACSI
2021-01-05,2021,1,REG,04,La Réunion,0.0,0.0,0.0,25,0,0,30,0,0,VACSI
2021-01-12,2021,2,REG,04,La Réunion,0.1,0.0,0.0,445,2,0,475,2,0,VACSI
2021-01-19,2021,3,REG,04,La Réunion,0.3,0.0,0.0,2141,3,0,2616,5,0,VACSI
2021-01-26,2021,4,REG,04,La Réunion,0.6,0.0,0.0,2273,21,0,4889,26,0,VACSI
2021-02-02,2021,5,REG,04,La Réunion,1.0,0.0,0.0,3046,158,0,7935,184,0,VACSI
2021-02-09,2021,6,REG,04,La Réunion,1.5,0.1,0.0,4145,571,0,12080,755,0,VACSI
2021-02-16,2021,7,REG,04,La Réunion,2.0,0.3,0.0,3123,1858,0,15203,2613,0,VACSI
2021-02-23,2021,8,REG,04,La Réunion,2.5,0.5,0.0,2900,1880,0,18103,4493,0,VACSI
2021-03-02,2021,9,REG,04,La Réunion,2.9,0.9,0.0,3932,3041,0,22035,7534,0,VACSI
2021-03-09,2021,10,REG,04,La Réunion,3.5,1.5,0.0,3882,3872,0,25917,11406,0,VACSI
2021-03-16,2021,11,REG,04,La Réunion,4.1,1.9,0.0,4409,3240,0,30326,14646,0,VACSI
2021-03-23,2021,12,REG,04,La Réunion,4.7,2.4,0.0,5147,2810,0,35473,17456,0,VACSI
2021-03-30,2021,13,REG,04,La Réunion,5.4,2.8,0.0,3807,3221,0,39280,20677,0,VACSI
2021-04-06,2021,14,REG,04,La Réunion,6.3,3.3,0.0,7803,4072,0,47083,24749,0,VACSI
2021-04-13,2021,15,REG,04,La Réunion,7.7,3.9,0.0,10572,4306,0,57655,29055,0,VACSI
2021-04-20,2021,16,REG,04,La Réunion,9.4,4.5,0.0,11255,4704,0,68910,33759,0,VACSI
2021-04-27,2021,17,REG,04,La Réunion,11.4,5.2,0.0,15848,4302,0,84758,38061,0,VACSI
2021-05-04,2021,18,REG,04,La Réunion,13.7,6.2,0.0,16492,7348,0,101250,45409,0,VACSI
2021-05-11,2021,19,REG,04,La Réunion,16.6,7.4,0.0,22966,10065,0,124216,55474,0,VACSI
2021-05-18,2021,20,REG,04,La Réunion,20.1,9.1,0.0,25356,11881,0,149572,67355,0,VACSI
2021-05-25,2021,21,REG,04,La Réunion,23.6,11.3,0.0,23152,17350,0,172724,84705,0,VACSI
2021-06-01,2021,22,REG,04,La Réunion,26.4,13.8,0.0,20658,17981,0,193382,102686,0,VACSI
2021-06-08,2021,23,REG,04,La Réunion,28.9,16.8,0.0,16664,23639,0,210046,126325,0,VACSI
2021-06-15,2021,24,REG,04,La Réunion,31.0,20.3,0.0,13443,24768,0,223489,151093,0,VACSI
2021-06-22,2021,25,REG,04,La Réunion,32.6,23.6,0.0,11900,22284,0,235389,173377,0,VACSI
2021-06-29,2021,26,REG,04,La Réunion,34.5,26.4,0.0,13927,19924,0,249316,193301,0,VACSI
2021-07-06,2021,27,REG,04,La Réunion,36.6,28.9,0.0,14781,18279,0,264097,211580,0,VACSI
2021-07-13,2021,28,REG,04,La Réunion,39.9,31.4,0.0,30961,16270,0,295058,227850,0,VACSI
2021-07-20,2021,29,REG,04,La Réunion,45.3,33.6,0.0,37629,16431,0,332687,244281,0,VACSI
2021-07-27,2021,30,REG,04,La Réunion,50.0,35.9,0.0,32397,15432,0,365084,259713,0,VACSI
2021-08-03,2021,31,REG,04,La Réunion,53.9,39.1,0.0,25088,28707,0,390172,288420,0,VACSI
2021-08-10,2021,32,REG,04,La Réunion,57.4,43.7,0.0,24528,32944,0,414700,321364,0,VACSI
2021-08-17,2021,33,REG,04,La Réunion,60.2,48.1,0.0,18205,30890,0,432905,352254,0,VACSI
2021-08-24,2021,34,REG,04,La Réunion,62.4,52.0,0.0,15175,25388,9,448080,377642,9,VACSI
2021-08-31,2021,35,REG,04,La Réunion,64.3,55.6,0.0,12539,25147,295,460619,402789,304,VACSI
2021-09-07,2021,36,REG,04,La Réunion,65.8,58.7,0.1,10462,19663,578,471081,422452,882,VACSI
2021-09-14,2021,37,REG,04,La Réunion,67.2,61.0,0.2,8661,15743,786,479742,438195,1668,VACSI
2021-09-21,2021,38,REG,04,La Réunion,68.1,62.9,0.4,5757,12639,1109,485499,450834,2777,VACSI
2021-09-28,2021,39,REG,04,La Réunion,68.9,64.5,0.5,6508,10797,1132,492007,461631,3909,VACSI
2021-10-05,2021,40,REG,04,La Réunion,69.8,65.9,0.7,6611,9189,1507,498618,470820,5416,VACSI
2021-10-12,2021,41,REG,04,La Réunion,70.9,66.9,0.9,7120,6783,1650,505738,477603,7066,VACSI
2021-10-19,2021,42,REG,04,La Réunion,71.7,67.8,1.2,5549,6478,1945,511287,484081,9011,VACSI
2021-10-26,2021,43,REG,04,La Réunion,72.4,68.7,1.5,4564,5994,2116,515851,490075,11127,VACSI
2021-11-02,2021,44,REG,04,La Réunion,73.0,69.7,1.8,4299,7180,2464,520150,497255,13591,VACSI
2021-11-09,2021,45,REG,04,La Réunion,73.5,70.5,2.2,3913,5518,3605,524063,502773,17196,VACSI
2021-11-16,2021,46,REG,04,La Réunion,74.2,71.3,3.0,4933,5077,5709,528996,507850,22905,VACSI
2021-11-23,2021,47,REG,04,La Réunion,74.9,71.9,4.2,4472,4858,13079,533468,512708,35984,VACSI
2021-11-30,2021,48,REG,04,La Réunion,75.4,72.5,8.0,3782,4338,28984,537250,517046,64968,VACSI
2021-12-07,2021,49,REG,04,La Réunion,75.9,73.2,12.5,3521,4996,31590,540771,522042,96558,VACSI
2021-12-14,2021,50,REG,04,La Réunion,76.4,73.9,16.9,2795,4010,27116,543566,526052,123674,VACSI
2021-12-21,2021,51,REG,04,La Réunion,76.7,74.4,19.5,2385,3693,18727,545951,529745,142401,VACSI
2021-12-28,2021,52,REG,04,La Réunion,77.1,74.8,22.4,2529,2963,21749,548480,532708,164150,VACSI
2022-01-04,2022,1,REG,04,La Réunion,77.6,75.3,27.0,4378,3512,38259,552858,536220,202409,VACSI
2022-01-11,2022,2,REG,04,La Réunion,78.3,75.8,32.3,4765,3128,37094,557623,539348,239503,VACSI
2022-01-18,2022,3,REG,04,La Réunion,78.8,76.1,36.5,3801,2643,25702,561424,541991,265205,VACSI
2022-01-25,2022,4,REG,04,La Réunion,79.0,76.3,37.8,442,474,3294,561866,542465,268499,VACSI
2020-12-22,2020,52,REG,06,Mayotte,0.0,0.0,0.0,1,0,0,1,0,0,VACSI
2020-12-29,2020,53,REG,06,Mayotte,0.0,0.0,0.0,2,0,0,3,0,0,VACSI
2021-01-05,2021,1,REG,06,Mayotte,0.0,0.0,0.0,2,0,0,5,0,0,VACSI
2021-01-12,2021,2,REG,06,Mayotte,0.0,0.0,0.0,13,0,0,18,0,0,VACSI
2021-01-19,2021,3,REG,06,Mayotte,0.0,0.0,0.0,120,3,0,138,3,0,VACSI
2021-01-26,2021,4,REG,06,Mayotte,0.4,0.0,0.0,1003,31,0,1141,34,0,VACSI
2021-02-02,2021,5,REG,06,Mayotte,1.1,0.0,0.0,1041,39,0,2182,73,0,VACSI
2021-02-09,2021,6,REG,06,Mayotte,1.7,0.1,0.0,1213,36,0,3395,109,0,VACSI
2021-02-16,2021,7,REG,06,Mayotte,2.3,0.1,0.0,899,157,0,4294,266,0,VACSI
2021-02-23,2021,8,REG,06,Mayotte,2.8,0.5,0.0,798,923,0,5092,1189,0,VACSI
2021-03-02,2021,9,REG,06,Mayotte,3.2,1.0,0.0,869,759,0,5961,1948,0,VACSI
2021-03-09,2021,10,REG,06,Mayotte,3.8,1.5,0.0,963,1058,0,6924,3006,0,VACSI
2021-03-16,2021,11,REG,06,Mayotte,4.2,2.1,0.0,746,795,0,7670,3801,0,VACSI
2021-03-23,2021,12,REG,06,Mayotte,4.6,2.5,0.0,548,648,0,8218,4449,0,VACSI
2021-03-30,2021,13,REG,06,Mayotte,5.1,2.8,0.0,1696,911,0,9914,5360,0,VACSI
2021-04-06,2021,14,REG,06,Mayotte,6.0,3.4,0.0,1038,840,0,10952,6200,0,VACSI
2021-04-13,2021,15,REG,06,Mayotte,6.6,3.8,0.0,1160,766,0,12112,6966,0,VACSI
2021-04-20,2021,16,REG,06,Mayotte,7.5,4.2,0.0,1854,698,0,13966,7664,0,VACSI
2021-04-27,2021,17,REG,06,Mayotte,8.6,4.9,0.0,2261,1450,0,16227,9114,0,VACSI
2021-05-04,2021,18,REG,06,Mayotte,9.8,5.6,0.0,1647,1096,0,17874,10210,0,VACSI
2021-05-11,2021,19,REG,06,Mayotte,10.4,6.1,0.0,1318,1108,0,19192,11318,0,VACSI
2021-05-18,2021,20,REG,06,Mayotte,12.4,7.3,0.0,4197,2006,0,23389,13324,0,VACSI
2021-05-25,2021,21,REG,06,Mayotte,15.2,8.6,0.0,5087,2460,0,28476,15784,0,VACSI
2021-06-01,2021,22,REG,06,Mayotte,18.1,9.8,0.0,4747,1984,0,33223,17768,0,VACSI
2021-06-08,2021,23,REG,06,Mayotte,20.4,10.7,0.0,4059,1798,0,37282,19566,0,VACSI
2021-06-15,2021,24,REG,06,Mayotte,22.3,12.8,0.0,3296,4036,0,40578,23602,0,VACSI
2021-06-22,2021,25,REG,06,Mayotte,23.8,14.9,0.0,2559,3924,0,43137,27526,0,VACSI
2021-06-29,2021,26,REG,06,Mayotte,25.4,16.9,0.0,2933,3353,0,46070,30879,0,VACSI
2021-07-06,2021,27,REG,06,Mayotte,27.2,18.8,0.0,3323,3285,0,49393,34164,0,VACSI
2021-07-13,2021,28,REG,06,Mayotte,29.3,20.3,0.0,4181,2715,0,53574,36879,0,VACSI
2021-07-20,2021,29,REG,06,Mayotte,31.7,21.6,0.0,4229,2355,0,57803,39234,0,VACSI
2021-07-27,2021,30,REG,06,Mayotte,34.7,23.1,0.0,5469,2711,0,63272,41945,0,VACSI
2021-08-03,2021,31,REG,06,Mayotte,38.8,24.8,0.0,7764,3130,0,71036,45075,0,VACSI
2021-08-10,2021,32,REG,06,Mayotte,43.4,27.1,0.0,8096,4258,0,79132,49333,0,VACSI
2021-08-17,2021,33,REG,06,Mayotte,48.4,29.4,0.0,9282,4241,0,88414,53574,0,VACSI
2021-08-24,2021,34,REG,06,Mayotte,51.4,31.7,0.0,4317,4413,3,92731,57987,3,VACSI
2021-08-31,2021,35,REG,06,Mayotte,53.5,34.9,0.0,4071,6099,21,96802,64086,24,VACSI
2021-09-07,2021,36,REG,06,Mayotte,56.2,38.0,0.0,5139,5705,30,101941,69791,54,VACSI
2021-09-14,2021,37,REG,06,Mayotte,60.4,41.1,0.0,8289,5221,20,110230,75012,74,VACSI
2021-09-21,2021,38,REG,06,Mayotte,64.5,43.8,0.0,6683,4512,11,116913,79524,85,VACSI
2021-09-28,2021,39,REG,06,Mayotte,67.9,46.6,0.1,6053,5193,25,122966,84717,110,VACSI
2021-10-05,2021,40,REG,06,Mayotte,70.9,49.9,0.1,5652,6382,28,128618,91099,138,VACSI
2021-10-12,2021,41,REG,06,Mayotte,74.7,54.0,0.1,6320,6845,50,134938,97944,188,VACSI
2021-10-19,2021,42,REG,06,Mayotte,76.9,57.0,0.1,3838,5415,52,138776,103359,240,VACSI
2021-10-26,2021,43,REG,06,Mayotte,78.8,60.0,0.2,2657,4645,79,141433,108004,319,VACSI
2021-11-02,2021,44,REG,06,Mayotte,80.1,62.7,0.2,2567,5593,109,144000,113597,428,VACSI
2021-11-09,2021,45,REG,06,Mayotte,81.0,64.8,0.3,1676,3350,155,145676,116947,583,VACSI
2021-11-16,2021,46,REG,06,Mayotte,82.0,66.7,0.4,1690,3171,242,147366,120118,825,VACSI
2021-11-23,2021,47,REG,06,Mayotte,82.9,68.3,0.8,1510,2755,1114,148876,122873,1939,VACSI
2021-11-30,2021,48,REG,06,Mayotte,83.6,69.3,2.4,1109,1717,2861,149985,124590,4800,VACSI
2021-12-07,2021,49,REG,06,Mayotte,84.1,70.1,3.5,928,1453,1895,150913,126043,6695,VACSI
2021-12-14,2021,50,REG,06,Mayotte,84.6,71.0,4.5,797,1317,1604,151710,127360,8299,VACSI
2021-12-21,2021,51,REG,06,Mayotte,85.0,71.6,5.4,730,1047,1498,152440,128407,9797,VACSI
2021-12-28,2021,52,REG,06,Mayotte,85.4,72.1,6.5,671,915,2054,153111,129322,11851,VACSI
2022-01-04,2022,1,REG,06,Mayotte,86.0,72.7,8.3,1256,1239,3825,154367,130561,15676,VACSI
2022-01-11,2022,2,REG,06,Mayotte,86.6,73.3,10.4,1065,984,3834,155432,131545,19510,VACSI
2022-01-18,2022,3,REG,06,Mayotte,87.1,73.8,12.3,775,860,3235,156207,132405,22745,VACSI
2022-01-25,2022,4,REG,06,Mayotte,87.2,74.0,13.0,120,160,511,156327,132565,23256,VACSI
2020-12-22,2020,52,REG,11,Île-de-France,0.0,0.0,0.0,139,5,0,139,5,0,VACSI
2020-12-29,2020,53,REG,11,Île-de-France,0.0,0.0,0.0,1341,20,0,1480,25,0,VACSI
2021-01-05,2021,1,REG,11,Île-de-France,0.2,0.0,0.0,29462,275,0,30942,300,0,VACSI
2021-01-12,2021,2,REG,11,Île-de-France,0.6,0.0,0.0,56180,770,0,87122,1070,0,VACSI
2021-01-19,2021,3,REG,11,Île-de-France,1.55,0.0,0.0,93108,1154,0,180230,2224,0,VACSI
2021-01-26,2021,4,REG,11,Île-de-France,2.3499999999999996,0.1,0.0,79722,6160,0,259952,8384,0,VACSI
2021-02-02,2021,5,REG,11,Île-de-France,2.8499999999999996,0.2,0.0,47234,23495,0,307186,31879,0,VACSI
2021-02-09,2021,6,REG,11,Île-de-France,3.4,0.8,0.0,51812,64373,0,358998,96252,0,VACSI
2021-02-16,2021,7,REG,11,Île-de-France,3.7,1.6,0.0,36527,87515,0,395525,183767,0,VACSI
2021-02-23,2021,8,REG,11,Île-de-France,4.1,2.1500000000000004,0.0,47306,59143,0,442831,242910,0,VACSI
2021-03-02,2021,9,REG,11,Île-de-France,5.1,2.75,0.0,197830,60899,0,640661,303809,0,VACSI
2021-03-09,2021,10,REG,11,Île-de-France,7.35,3.25,0.0,223347,48581,0,864008,352390,0,VACSI
2021-03-16,2021,11,REG,11,Île-de-France,9.3,3.5,0.0,184808,27038,0,1048816,379428,0,VACSI
2021-03-23,2021,12,REG,11,Île-de-France,11.8,3.8,0.0,283770,38380,0,1332586,417808,0,VACSI
2021-03-30,2021,13,REG,11,Île-de-France,14.3,4.6,0.0,206656,106686,0,1539242,524494,0,VACSI
2021-04-06,2021,14,REG,11,Île-de-France,16.35,5.75,0.0,242473,134332,0,1781715,658826,0,VACSI
2021-04-13,2021,15,REG,11,Île-de-France,18.6,7.35,0.0,217917,156763,0,1999632,815589,0,VACSI
2021-04-20,2021,16,REG,11,Île-de-France,20.5,9.0,0.0,237945,187276,0,2237577,1002865,0,VACSI
2021-04-27,2021,17,REG,11,Île-de-France,23.45,10.85,0.0,313935,177085,0,2551512,1179950,0,VACSI
2021-05-04,2021,18,REG,11,Île-de-France,26.65,12.7,0.0,408461,210669,0,2959973,1390619,0,VACSI
2021-05-11,2021,19,REG,11,Île-de-France,31.05,14.35,0.0,511611,149226,0,3471584,1539845,0,VACSI
2021-05-18,2021,20,REG,11,Île-de-France,36.6,15.75,0.0,578731,137872,0,4050315,1677717,0,VACSI
2021-05-25,2021,21,REG,11,Île-de-France,41.2,17.4,0.0,514246,232351,0,4564561,1910068,0,VACSI
2021-06-01,2021,22,REG,11,Île-de-France,45.9,20.05,0.0,504945,333809,0,5069506,2243877,0,VACSI
2021-06-08,2021,23,REG,11,Île-de-France,49.6,23.799999999999997,0.0,403929,423476,0,5473435,2667353,0,VACSI
2021-06-15,2021,24,REG,11,Île-de-France,52.85,28.299999999999997,0.0,296327,523887,0,5769762,3191240,0,VACSI
2021-06-22,2021,25,REG,11,Île-de-France,55.2,33.6,0.0,229525,618250,1,5999287,3809490,1,VACSI
2021-06-29,2021,26,REG,11,Île-de-France,57.25,39.4,0.0,227471,635737,2,6226758,4445227,3,VACSI
2021-07-06,2021,27,REG,11,Île-de-France,59.5,44.95,0.0,242926,611758,5,6469684,5056985,8,VACSI
2021-07-13,2021,28,REG,11,Île-de-France,62.45,50.45,0.0,370792,567237,1,6840476,5624222,9,VACSI
2021-07-20,2021,29,REG,11,Île-de-France,67.15,55.5,0.0,453973,496794,5,7294449,6121016,14,VACSI
2021-07-27,2021,30,REG,11,Île-de-France,71.94999999999999,59.35,0.0,430868,355765,1,7725317,6476781,15,VACSI
2021-08-03,2021,31,REG,11,Île-de-France,75.25,62.35,0.0,269259,295862,0,7994576,6772643,15,VACSI
2021-08-10,2021,32,REG,11,Île-de-France,77.44999999999999,65.5,0.0,190156,305441,2,8184732,7078084,17,VACSI
2021-08-17,2021,33,REG,11,Île-de-France,78.94999999999999,69.0,0.0,150402,355107,0,8335134,7433191,17,VACSI
2021-08-24,2021,34,REG,11,Île-de-France,80.5,72.9,0.0,140042,356494,1371,8475176,7789685,1388,VACSI
2021-08-31,2021,35,REG,11,Île-de-France,81.9,76.0,0.2,119885,243863,28232,8595061,8033548,29620,VACSI
2021-09-07,2021,36,REG,11,Île-de-France,82.80000000000001,77.7,0.45,80527,157184,32587,8675588,8190732,62207,VACSI
2021-09-14,2021,37,REG,11,Île-de-France,83.65,79.1,0.8500000000000001,64206,129907,43903,8739794,8320639,106110,VACSI
2021-09-21,2021,38,REG,11,Île-de-France,84.15,80.3,1.3,45984,110315,42801,8785778,8430954,148911,VACSI
2021-09-28,2021,39,REG,11,Île-de-France,84.6,81.35,1.65,51137,79719,46690,8836915,8510673,195601,VACSI
2021-10-05,2021,40,REG,11,Île-de-France,85.05,82.15,2.2,41277,66978,62439,8878192,8577651,258040,VACSI
2021-10-12,2021,41,REG,11,Île-de-France,85.45,82.80000000000001,2.9,37988,57216,73830,8916180,8634867,331870,VACSI
2021-10-19,2021,42,REG,11,Île-de-France,85.80000000000001,83.35,3.6500000000000004,31913,49535,86183,8948093,8684402,418053,VACSI
2021-10-26,2021,43,REG,11,Île-de-France,86.1,83.75,4.55,24151,34783,79352,8972244,8719185,497405,VACSI
2021-11-02,2021,44,REG,11,Île-de-France,86.30000000000001,84.1,5.300000000000001,25246,37876,96848,8997490,8757061,594253,VACSI
2021-11-09,2021,45,REG,11,Île-de-France,86.6,84.45,6.5,21897,33854,128094,9019387,8790915,722347,VACSI
2021-11-16,2021,46,REG,11,Île-de-France,86.80000000000001,84.75,8.05,25950,34953,169169,9045337,8825868,891516,VACSI
2021-11-23,2021,47,REG,11,Île-de-France,87.1,85.15,10.1,24589,33449,299584,9069926,8859317,1191100,VACSI
2021-11-30,2021,48,REG,11,Île-de-France,87.30000000000001,85.45,14.6,20444,32289,578290,9090370,8891606,1769390,VACSI
2021-12-07,2021,49,REG,11,Île-de-France,87.55,85.75,20.75,22294,36440,759829,9112664,8928046,2529219,VACSI
2021-12-14,2021,50,REG,11,Île-de-France,87.75,86.05,28.549999999999997,27247,37825,850265,9139911,8965871,3379484,VACSI
2021-12-21,2021,51,REG,11,Île-de-France,88.05,86.4,34.85,24076,27452,508881,9163987,8993323,3888365,VACSI
2021-12-28,2021,52,REG,11,Île-de-France,88.25,86.65,39.15,21908,24488,460014,9185895,9017811,4348379,VACSI
2022-01-04,2022,1,REG,11,Île-de-France,88.55,86.9,44.5,32142,37017,619273,9218037,9054828,4967652,VACSI
2022-01-11,2022,2,REG,11,Île-de-France,88.85,87.25,49.95,21661,30321,457717,9239698,9085149,5425369,VACSI
2022-01-18,2022,3,REG,11,Île-de-France,89.05,87.5,53.5,14553,24856,280557,9254251,9110005,5705926,VACSI
2022-01-25,2022,4,REG,11,Île-de-France,89.15,87.65,54.9,1874,3719,36254,9256125,9113724,5742180,VACSI
2020-12-22,2020,52,REG,24,Centre-Val de Loire,0.0,0.0,0.0,20,1,0,20,1,0,VACSI
2020-12-29,2020,53,REG,24,Centre-Val de Loire,0.0,0.0,0.0,47,0,0,67,1,0,VACSI
2021-01-05,2021,1,REG,24,Centre-Val de Loire,0.1,0.0,0.0,4335,13,0,4402,14,0,VACSI
2021-01-12,2021,2,REG,24,Centre-Val de Loire,0.6499999999999999,0.0,0.0,13671,114,0,18073,128,0,VACSI
2021-01-19,2021,3,REG,24,Centre-Val de Loire,2.05,0.0,0.0,29963,137,0,48036,265,0,VACSI
2021-01-26,2021,4,REG,24,Centre-Val de Loire,2.95,0.1,0.0,22194,3171,0,70230,3436,0,VACSI
2021-02-02,2021,5,REG,24,Centre-Val de Loire,3.55,0.45,0.0,14301,8339,0,84531,11775,0,VACSI
2021-02-09,2021,6,REG,24,Centre-Val de Loire,4.449999999999999,1.25,0.0,18753,18774,0,103284,30549,0,VACSI
2021-02-16,2021,7,REG,24,Centre-Val de Loire,5.15,2.1500000000000004,0.0,15452,22597,0,118736,53146,0,VACSI
2021-02-23,2021,8,REG,24,Centre-Val de Loire,5.9,2.8499999999999996,0.0,16775,15833,0,135511,68979,0,VACSI
2021-03-02,2021,9,REG,24,Centre-Val de Loire,7.1,3.5999999999999996,0.0,32625,16872,0,168136,85851,0,VACSI
2021-03-09,2021,10,REG,24,Centre-Val de Loire,9.25,4.4,0.0,44834,15690,0,212970,101541,0,VACSI
2021-03-16,2021,11,REG,24,Centre-Val de Loire,11.2,4.9,0.0,32697,11176,0,245667,112717,0,VACSI
2021-03-23,2021,12,REG,24,Centre-Val de Loire,13.5,5.45,0.0,56951,11354,0,302618,124071,0,VACSI
2021-03-30,2021,13,REG,24,Centre-Val de Loire,16.1,6.3,0.0,48278,14770,0,350896,138841,0,VACSI
2021-04-06,2021,14,REG,24,Centre-Val de Loire,19.05,7.449999999999999,0.0,75248,24275,0,426144,163116,0,VACSI
2021-04-13,2021,15,REG,24,Centre-Val de Loire,22.9,8.95,0.0,78880,26253,0,505024,189369,0,VACSI
2021-04-20,2021,16,REG,24,Centre-Val de Loire,26.15,10.5,0.0,76412,37085,0,581436,226454,0,VACSI
2021-04-27,2021,17,REG,24,Centre-Val de Loire,30.3,12.4,0.0,79174,40603,0,660610,267057,0,VACSI
2021-05-04,2021,18,REG,24,Centre-Val de Loire,34.150000000000006,14.75,0.0,79742,60906,0,740352,327963,0,VACSI
2021-05-11,2021,19,REG,24,Centre-Val de Loire,37.3,17.6,0.0,87407,54039,0,827759,382002,0,VACSI
2021-05-18,2021,20,REG,24,Centre-Val de Loire,42.0,19.65,0.0,100767,40841,0,928526,422843,0,VACSI
2021-05-25,2021,21,REG,24,Centre-Val de Loire,46.35,21.4,0.0,111031,57072,0,1039557,479915,0,VACSI
2021-06-01,2021,22,REG,24,Centre-Val de Loire,51.6,24.4,0.0,108261,74127,0,1147818,554042,0,VACSI
2021-06-08,2021,23,REG,24,Centre-Val de Loire,55.65,28.15,0.0,91591,81791,0,1239409,635833,0,VACSI
2021-06-15,2021,24,REG,24,Centre-Val de Loire,58.599999999999994,32.65,0.0,73055,97476,1,1312464,733309,1,VACSI
2021-06-22,2021,25,REG,24,Centre-Val de Loire,60.95,36.75,0.0,52959,105815,0,1365423,839124,1,VACSI
2021-06-29,2021,26,REG,24,Centre-Val de Loire,62.85,42.65,0.0,44628,125304,0,1410051,964428,1,VACSI
2021-07-06,2021,27,REG,24,Centre-Val de Loire,64.9,48.4,0.0,43809,136304,0,1453860,1100732,1,VACSI
2021-07-13,2021,28,REG,24,Centre-Val de Loire,66.95,54.2,0.0,54974,125604,0,1508834,1226336,1,VACSI
2021-07-20,2021,29,REG,24,Centre-Val de Loire,70.94999999999999,59.4,0.0,88650,119238,1,1597484,1345574,2,VACSI
2021-07-27,2021,30,REG,24,Centre-Val de Loire,75.4,63.55,0.0,99179,85528,0,1696663,1431102,2,VACSI
2021-08-03,2021,31,REG,24,Centre-Val de Loire,79.35,66.5,0.0,83161,61169,0,1779824,1492271,2,VACSI
2021-08-10,2021,32,REG,24,Centre-Val de Loire,82.05000000000001,69.4,0.0,53825,66778,0,1833649,1559049,2,VACSI
2021-08-17,2021,33,REG,24,Centre-Val de Loire,83.95,73.0,0.0,36697,83358,0,1870346,1642407,2,VACSI
2021-08-24,2021,34,REG,24,Centre-Val de Loire,85.35,76.75,0.0,30409,89083,215,1900755,1731490,217,VACSI
2021-08-31,2021,35,REG,24,Centre-Val de Loire,86.55,80.0,0.2,22336,68466,5913,1923091,1799956,6130,VACSI
2021-09-07,2021,36,REG,24,Centre-Val de Loire,87.4,82.3,0.5,15753,41217,7482,1938844,1841173,13612,VACSI
2021-09-14,2021,37,REG,24,Centre-Val de Loire,88.1,84.05,1.0,13009,30531,12477,1951853,1871704,26089,VACSI
2021-09-21,2021,38,REG,24,Centre-Val de Loire,88.5,85.25,1.6,9169,26118,14389,1961022,1897822,40478,VACSI
2021-09-28,2021,39,REG,24,Centre-Val de Loire,88.85,86.15,2.3,7929,16656,14633,1968951,1914478,55111,VACSI
2021-10-05,2021,40,REG,24,Centre-Val de Loire,89.15,86.9,3.1500000000000004,7332,14221,16933,1976283,1928699,72044,VACSI
2021-10-12,2021,41,REG,24,Centre-Val de Loire,89.4,87.44999999999999,4.0,6431,10915,18786,1982714,1939614,90830,VACSI
2021-10-19,2021,42,REG,24,Centre-Val de Loire,89.69999999999999,87.80000000000001,4.949999999999999,5660,8863,20559,1988374,1948477,111389,VACSI
2021-10-26,2021,43,REG,24,Centre-Val de Loire,89.9,88.1,5.95,4099,6107,18055,1992473,1954584,129444,VACSI
2021-11-02,2021,44,REG,24,Centre-Val de Loire,90.1,88.4,6.9,4609,7073,29524,1997082,1961657,158968,VACSI
2021-11-09,2021,45,REG,24,Centre-Val de Loire,90.30000000000001,88.69999999999999,8.45,3788,5619,34292,2000870,1967276,193260,VACSI
2021-11-16,2021,46,REG,24,Centre-Val de Loire,90.55,88.95,10.75,5276,5714,52841,2006146,1972990,246101,VACSI
2021-11-23,2021,47,REG,24,Centre-Val de Loire,90.75,89.19999999999999,13.649999999999999,5068,5377,74746,2011214,1978367,320847,VACSI
2021-11-30,2021,48,REG,24,Centre-Val de Loire,91.0,89.45,19.1,3681,4659,125995,2014895,1983026,446842,VACSI
2021-12-07,2021,49,REG,24,Centre-Val de Loire,91.15,89.69999999999999,26.200000000000003,3986,5673,167988,2018881,1988699,614830,VACSI
2021-12-14,2021,50,REG,24,Centre-Val de Loire,91.35,90.0,34.65,4899,6403,196882,2023780,1995102,811712,VACSI
2021-12-21,2021,51,REG,24,Centre-Val de Loire,91.55,90.19999999999999,40.150000000000006,4010,3581,99792,2027790,1998683,911504,VACSI
2021-12-28,2021,52,REG,24,Centre-Val de Loire,91.65,90.30000000000001,43.95,3420,3237,88765,2031210,2001920,1000269,VACSI
2022-01-04,2022,1,REG,24,Centre-Val de Loire,92.0,90.6,51.400000000000006,7611,6514,178239,2038821,2008434,1178508,VACSI
2022-01-11,2022,2,REG,24,Centre-Val de Loire,92.30000000000001,90.85,58.45,6181,5596,139089,2045002,2014030,1317597,VACSI
2022-01-18,2022,3,REG,24,Centre-Val de Loire,92.44999999999999,91.0,63.0,3806,4308,87099,2048808,2018338,1404696,VACSI
2022-01-25,2022,4,REG,24,Centre-Val de Loire,92.55000000000001,91.15,64.75,567,909,12675,2049375,2019247,1417371,VACSI
2020-12-22,2020,52,REG,27,Bourgogne-Franche-Comté,0.0,0.0,0.0,20,0,0,20,0,0,VACSI
2020-12-29,2020,53,REG,27,Bourgogne-Franche-Comté,0.0,0.0,0.0,216,0,0,236,0,0,VACSI
2021-01-05,2021,1,REG,27,Bourgogne-Franche-Comté,0.15000000000000002,0.0,0.0,7573,26,0,7809,26,0,VACSI
2021-01-12,2021,2,REG,27,Bourgogne-Franche-Comté,0.95,0.0,0.0,22646,152,0,30455,178,0,VACSI
2021-01-19,2021,3,REG,27,Bourgogne-Franche-Comté,2.6500000000000004,0.0,0.0,40697,224,0,71152,402,0,VACSI
2021-01-26,2021,4,REG,27,Bourgogne-Franche-Comté,4.0,0.1,0.0,32201,4513,0,103353,4915,0,VACSI
2021-02-02,2021,5,REG,27,Bourgogne-Franche-Comté,4.85,0.6,0.0,18821,13383,0,122174,18298,0,VACSI
2021-02-09,2021,6,REG,27,Bourgogne-Franche-Comté,5.5,1.4,0.0,14455,23268,0,136629,41566,0,VACSI
2021-02-16,2021,7,REG,27,Bourgogne-Franche-Comté,5.8,2.6500000000000004,0.0,8776,32654,0,145405,74220,0,VACSI
2021-02-23,2021,8,REG,27,Bourgogne-Franche-Comté,6.25,3.8,0.0,15122,25073,0,160527,99293,0,VACSI
2021-03-02,2021,9,REG,27,Bourgogne-Franche-Comté,7.75,4.75,0.0,40221,19656,0,200748,118949,0,VACSI
2021-03-09,2021,10,REG,27,Bourgogne-Franche-Comté,9.75,5.4,0.0,53620,14742,0,254368,133691,0,VACSI
2021-03-16,2021,11,REG,27,Bourgogne-Franche-Comté,11.9,5.6,0.0,49244,6716,0,303612,140407,0,VACSI
2021-03-23,2021,12,REG,27,Bourgogne-Franche-Comté,15.25,5.9,0.0,82736,9899,0,386348,150306,0,VACSI
2021-03-30,2021,13,REG,27,Bourgogne-Franche-Comté,17.9,6.65,0.0,56973,17987,0,443321,168293,0,VACSI
2021-04-06,2021,14,REG,27,Bourgogne-Franche-Comté,20.35,7.55,0.0,67353,33668,0,510674,201961,0,VACSI
2021-04-13,2021,15,REG,27,Bourgogne-Franche-Comté,22.950000000000003,9.2,0.0,60176,42250,0,570850,244211,0,VACSI
2021-04-20,2021,16,REG,27,Bourgogne-Franche-Comté,24.75,11.4,0.0,52561,53836,0,623411,298047,0,VACSI
2021-04-27,2021,17,REG,27,Bourgogne-Franche-Comté,28.0,13.85,0.0,83996,48786,0,707407,346833,0,VACSI
2021-05-04,2021,18,REG,27,Bourgogne-Franche-Comté,31.6,16.15,0.0,86125,55715,0,793532,402548,0,VACSI
2021-05-11,2021,19,REG,27,Bourgogne-Franche-Comté,35.5,18.049999999999997,0.0,110225,44986,0,903757,447534,0,VACSI
2021-05-18,2021,20,REG,27,Bourgogne-Franche-Comté,40.650000000000006,19.799999999999997,0.0,101175,39601,0,1004932,487135,0,VACSI
2021-05-25,2021,21,REG,27,Bourgogne-Franche-Comté,44.05,22.0,0.0,86922,63620,0,1091854,550755,0,VACSI
2021-06-01,2021,22,REG,27,Bourgogne-Franche-Comté,47.8,24.6,0.0,95914,70976,0,1187768,621731,0,VACSI
2021-06-08,2021,23,REG,27,Bourgogne-Franche-Comté,52.55,27.7,0.0,96441,83778,0,1284209,705509,0,VACSI
2021-06-15,2021,24,REG,27,Bourgogne-Franche-Comté,55.5,31.65,0.0,72692,98092,0,1356901,803601,0,VACSI
2021-06-22,2021,25,REG,27,Bourgogne-Franche-Comté,57.650000000000006,36.05,0.0,51839,126826,0,1408740,930427,0,VACSI
2021-06-29,2021,26,REG,27,Bourgogne-Franche-Comté,59.55,41.55,0.0,49873,118528,1,1458613,1048955,1,VACSI
2021-07-06,2021,27,REG,27,Bourgogne-Franche-Comté,61.6,46.0,0.0,48963,109461,0,1507576,1158416,1,VACSI
2021-07-13,2021,28,REG,27,Bourgogne-Franche-Comté,64.45,50.599999999999994,0.0,81303,116211,0,1588879,1274627,1,VACSI
2021-07-20,2021,29,REG,27,Bourgogne-Franche-Comté,68.85,56.55,0.0,98907,124123,0,1687786,1398750,1,VACSI
2021-07-27,2021,30,REG,27,Bourgogne-Franche-Comté,73.35,60.25,0.0,110417,89721,2,1798203,1488471,3,VACSI
2021-08-03,2021,31,REG,27,Bourgogne-Franche-Comté,77.15,63.25,0.0,80211,76220,0,1878414,1564691,3,VACSI
2021-08-10,2021,32,REG,27,Bourgogne-Franche-Comté,79.75,66.5,0.0,55616,81124,0,1934030,1645815,3,VACSI
2021-08-17,2021,33,REG,27,Bourgogne-Franche-Comté,81.35,70.1,0.0,35247,92564,1,1969277,1738379,4,VACSI
2021-08-24,2021,34,REG,27,Bourgogne-Franche-Comté,82.65,74.15,0.0,28915,92970,206,1998192,1831349,210,VACSI
2021-08-31,2021,35,REG,27,Bourgogne-Franche-Comté,83.65,77.5,0.2,23355,65780,8056,2021547,1897129,8266,VACSI
2021-09-07,2021,36,REG,27,Bourgogne-Franche-Comté,84.4,79.7,0.6499999999999999,17084,41565,11382,2038631,1938694,19648,VACSI
2021-09-14,2021,37,REG,27,Bourgogne-Franche-Comté,85.0,81.3,1.2,14956,30813,14157,2053587,1969507,33805,VACSI
2021-09-21,2021,38,REG,27,Bourgogne-Franche-Comté,85.4,82.4,1.75,9477,23836,14959,2063064,1993343,48764,VACSI
2021-09-28,2021,39,REG,27,Bourgogne-Franche-Comté,85.75,83.25,2.3499999999999996,9151,17822,15970,2072215,2011165,64734,VACSI
2021-10-05,2021,40,REG,27,Bourgogne-Franche-Comté,86.0,83.95,3.1,7844,15942,18843,2080059,2027107,83577,VACSI
2021-10-12,2021,41,REG,27,Bourgogne-Franche-Comté,86.30000000000001,84.45,3.9,7386,12067,20864,2087445,2039174,104441,VACSI
2021-10-19,2021,42,REG,27,Bourgogne-Franche-Comté,86.55,84.85,4.85,6762,9702,24744,2094207,2048876,129185,VACSI
2021-10-26,2021,43,REG,27,Bourgogne-Franche-Comté,86.80000000000001,85.15,6.05,4807,6690,22560,2099014,2055566,151745,VACSI
2021-11-02,2021,44,REG,27,Bourgogne-Franche-Comté,87.0,85.4,7.15,5613,8017,34745,2104627,2063583,186490,VACSI
2021-11-09,2021,45,REG,27,Bourgogne-Franche-Comté,87.15,85.65,8.7,4546,6580,39757,2109173,2070163,226247,VACSI
2021-11-16,2021,46,REG,27,Bourgogne-Franche-Comté,87.35,85.9,10.9,6009,6922,54900,2115182,2077085,281147,VACSI
2021-11-23,2021,47,REG,27,Bourgogne-Franche-Comté,87.65,86.15,13.8,6059,6516,80449,2121241,2083601,361596,VACSI
2021-11-30,2021,48,REG,27,Bourgogne-Franche-Comté,87.85,86.4,19.25,5005,6189,142384,2126246,2089790,503980,VACSI
2021-12-07,2021,49,REG,27,Bourgogne-Franche-Comté,88.05,86.65,26.55,5213,6739,176999,2131459,2096529,680979,VACSI
2021-12-14,2021,50,REG,27,Bourgogne-Franche-Comté,88.25,86.9,34.349999999999994,6089,7510,191291,2137548,2104039,872270,VACSI
2021-12-21,2021,51,REG,27,Bourgogne-Franche-Comté,88.5,87.15,39.7,5034,5071,107571,2142582,2109110,979841,VACSI
2021-12-28,2021,52,REG,27,Bourgogne-Franche-Comté,88.7,87.3,43.95,4771,4377,105624,2147353,2113487,1085465,VACSI
2022-01-04,2022,1,REG,27,Bourgogne-Franche-Comté,88.95,87.6,50.150000000000006,8376,7653,170281,2155729,2121140,1255746,VACSI
2022-01-11,2022,2,REG,27,Bourgogne-Franche-Comté,89.25,87.85,55.900000000000006,6494,7056,128258,2162223,2128196,1384004,VACSI
2022-01-18,2022,3,REG,27,Bourgogne-Franche-Comté,89.4,88.1,59.5,3881,5452,74580,2166104,2133648,1458584,VACSI
2022-01-25,2022,4,REG,27,Bourgogne-Franche-Comté,89.5,88.15,60.75,514,850,9982,2166618,2134498,1468566,VACSI
2020-12-22,2020,52,REG,28,Normandie,0.0,0.0,0.0,11,0,0,11,0,0,VACSI
2020-12-29,2020,53,REG,28,Normandie,0.0,0.0,0.0,52,0,0,63,0,0,VACSI
2021-01-05,2021,1,REG,28,Normandie,0.2,0.0,0.0,12439,38,0,12502,38,0,VACSI
2021-01-12,2021,2,REG,28,Normandie,1.2,0.0,0.0,36285,246,0,48787,284,0,VACSI
2021-01-19,2021,3,REG,28,Normandie,2.6,0.0,0.0,33630,290,0,82417,574,0,VACSI
2021-01-26,2021,4,REG,28,Normandie,3.5,0.1,0.0,19638,5617,0,102055,6191,0,VACSI
2021-02-02,2021,5,REG,28,Normandie,4.3,0.7,0.0,18369,24032,0,120424,30223,0,VACSI
2021-02-09,2021,6,REG,28,Normandie,4.9,1.9,0.0,18331,28898,0,138755,59121,0,VACSI
2021-02-16,2021,7,REG,28,Normandie,5.7,2.7,0.0,12265,23294,0,151020,82415,0,VACSI
2021-02-23,2021,8,REG,28,Normandie,6.4,3.6,0.0,20360,20843,0,171380,103258,0,VACSI
2021-03-02,2021,9,REG,28,Normandie,7.6,4.3,0.0,44603,16986,0,215983,120244,0,VACSI
2021-03-09,2021,10,REG,28,Normandie,9.8,4.9,0.0,71134,11057,0,287117,131301,0,VACSI
2021-03-16,2021,11,REG,28,Normandie,11.7,5.1,0.0,54757,7722,0,341874,139023,0,VACSI
2021-03-23,2021,12,REG,28,Normandie,14.6,5.4,0.0,89286,11155,0,431160,150178,0,VACSI
2021-03-30,2021,13,REG,28,Normandie,17.6,6.2,0.0,74694,23650,0,505854,173828,0,VACSI
2021-04-06,2021,14,REG,28,Normandie,20.4,7.3,0.0,93862,41412,0,599716,215240,0,VACSI
2021-04-13,2021,15,REG,28,Normandie,23.9,8.6,0.0,91389,46235,0,691105,261475,0,VACSI
2021-04-20,2021,16,REG,28,Normandie,27.3,10.6,0.0,84820,62498,0,775925,323973,0,VACSI
2021-04-27,2021,17,REG,28,Normandie,30.8,12.8,0.0,97516,60098,0,873441,384071,0,VACSI
2021-05-04,2021,18,REG,28,Normandie,34.6,15.2,0.0,95944,79784,0,969385,463855,0,VACSI
2021-05-11,2021,19,REG,28,Normandie,37.8,17.6,0.0,134974,61826,0,1104359,525681,0,VACSI
2021-05-18,2021,20,REG,28,Normandie,43.0,19.8,0.0,125243,48667,0,1229602,574348,0,VACSI
2021-05-25,2021,21,REG,28,Normandie,47.0,22.1,0.0,123197,72769,0,1352799,647117,0,VACSI
2021-06-01,2021,22,REG,28,Normandie,51.8,25.5,0.0,139016,86966,0,1491815,734083,0,VACSI
2021-06-08,2021,23,REG,28,Normandie,56.4,28.6,0.0,122015,104917,0,1613830,839000,0,VACSI
2021-06-15,2021,24,REG,28,Normandie,59.4,33.2,0.0,98496,121688,0,1712326,960688,0,VACSI
2021-06-22,2021,25,REG,28,Normandie,61.7,38.3,0.0,69195,154478,0,1781521,1115166,0,VACSI
2021-06-29,2021,26,REG,28,Normandie,63.7,43.5,0.0,63213,155513,0,1844734,1270679,0,VACSI
2021-07-06,2021,27,REG,28,Normandie,66.0,48.5,0.0,61528,160523,0,1906262,1431202,0,VACSI
2021-07-13,2021,28,REG,28,Normandie,68.7,54.3,0.0,87319,166660,0,1993581,1597862,0,VACSI
2021-07-20,2021,29,REG,28,Normandie,72.5,60.0,0.0,110858,157049,0,2104439,1754911,0,VACSI
2021-07-27,2021,30,REG,28,Normandie,76.8,64.6,0.0,132800,115394,0,2237239,1870305,0,VACSI
2021-08-03,2021,31,REG,28,Normandie,81.0,68.1,0.0,108510,94719,0,2345749,1965024,0,VACSI
2021-08-10,2021,32,REG,28,Normandie,84.1,71.4,0.0,77986,96931,1,2423735,2061955,1,VACSI
2021-08-17,2021,33,REG,28,Normandie,86.1,75.2,0.0,50959,115087,1,2474694,2177042,2,VACSI
2021-08-24,2021,34,REG,28,Normandie,87.4,79.0,0.0,36817,116040,270,2511511,2293082,272,VACSI
2021-08-31,2021,35,REG,28,Normandie,88.4,82.6,0.2,26913,90462,8735,2538424,2383544,9007,VACSI
2021-09-07,2021,36,REG,28,Normandie,89.2,84.9,0.6,18536,57023,12146,2556960,2440567,21153,VACSI
2021-09-14,2021,37,REG,28,Normandie,89.9,86.4,1.2,16474,38190,16248,2573434,2478757,37401,VACSI
2021-09-21,2021,38,REG,28,Normandie,90.3,87.4,1.8,11017,28075,17517,2584451,2506832,54918,VACSI
2021-09-28,2021,39,REG,28,Normandie,90.6,88.2,2.5,9483,20284,17198,2593934,2527116,72116,VACSI
2021-10-05,2021,40,REG,28,Normandie,90.9,88.8,3.2,8172,16530,20525,2602106,2543646,92641,VACSI
2021-10-12,2021,41,REG,28,Normandie,91.2,89.4,4.0,7808,13647,24774,2609914,2557293,117415,VACSI
2021-10-19,2021,42,REG,28,Normandie,91.5,89.8,4.9,6847,10981,28573,2616761,2568274,145988,VACSI
2021-10-26,2021,43,REG,28,Normandie,91.7,90.1,6.0,4923,7039,26923,2621684,2575313,172911,VACSI
2021-11-02,2021,44,REG,28,Normandie,91.9,90.4,6.9,6003,8596,38713,2627687,2583909,211624,VACSI
2021-11-09,2021,45,REG,28,Normandie,92.1,90.6,8.5,4915,7014,46882,2632602,2590923,258506,VACSI
2021-11-16,2021,46,REG,28,Normandie,92.3,90.9,10.8,6389,6862,68177,2638991,2597785,326683,VACSI
2021-11-23,2021,47,REG,28,Normandie,92.5,91.1,13.9,6570,6901,103332,2645561,2604686,430015,VACSI
2021-11-30,2021,48,REG,28,Normandie,92.7,91.3,20.7,5371,6062,182656,2650932,2610748,612671,VACSI
2021-12-07,2021,49,REG,28,Normandie,92.9,91.6,27.9,5610,7022,234603,2656542,2617770,847274,VACSI
2021-12-14,2021,50,REG,28,Normandie,93.1,91.8,36.8,7056,8110,262567,2663598,2625880,1109841,VACSI
2021-12-21,2021,51,REG,28,Normandie,93.3,92.0,42.7,5524,4977,130454,2669122,2630857,1240295,VACSI
2021-12-28,2021,52,REG,28,Normandie,93.5,92.2,46.9,5652,5153,136269,2674774,2636010,1376564,VACSI
2022-01-04,2022,1,REG,28,Normandie,93.8,92.5,53.6,9625,8407,223388,2684399,2644417,1599952,VACSI
2022-01-11,2022,2,REG,28,Normandie,94.1,92.7,59.8,7282,7229,165264,2691681,2651646,1765216,VACSI
2022-01-18,2022,3,REG,28,Normandie,94.2,92.9,64.1,4360,6008,101118,2696041,2657654,1866334,VACSI
2022-01-25,2022,4,REG,28,Normandie,94.3,93.0,65.4,575,962,13463,2696616,2658616,1879797,VACSI
2020-12-22,2020,52,REG,32,Hauts-de-France,0.0,0.0,0.0,32,0,0,32,0,0,VACSI
2020-12-29,2020,53,REG,32,Hauts-de-France,0.0,0.0,0.0,136,4,0,168,4,0,VACSI
2021-01-05,2021,1,REG,32,Hauts-de-France,0.1,0.0,0.0,11729,58,0,11897,62,0,VACSI
2021-01-12,2021,2,REG,32,Hauts-de-France,0.6,0.0,0.0,31136,225,0,43033,287,0,VACSI
2021-01-19,2021,3,REG,32,Hauts-de-France,1.7,0.0,0.0,53888,383,0,96921,670,0,VACSI
2021-01-26,2021,4,REG,32,Hauts-de-France,2.4,0.1,0.0,27358,6639,0,124279,7309,0,VACSI
2021-02-02,2021,5,REG,32,Hauts-de-France,2.8,0.4,0.0,13950,17971,0,138229,25280,0,VACSI
2021-02-09,2021,6,REG,32,Hauts-de-France,3.1,0.9,0.0,20318,29783,0,158547,55063,0,VACSI
2021-02-16,2021,7,REG,32,Hauts-de-France,3.6,1.7,0.0,28694,45304,0,187241,100367,0,VACSI
2021-02-23,2021,8,REG,32,Hauts-de-France,4.6,2.5,0.0,52301,22056,0,239542,122423,0,VACSI
2021-03-02,2021,9,REG,32,Hauts-de-France,6.0,2.7,0.0,113202,13426,0,352744,135849,0,VACSI
2021-03-09,2021,10,REG,32,Hauts-de-France,8.7,3.1,0.0,152438,24263,0,505182,160112,0,VACSI
2021-03-16,2021,11,REG,32,Hauts-de-France,10.9,3.6,0.0,115881,24803,0,621063,184915,0,VACSI
2021-03-23,2021,12,REG,32,Hauts-de-France,13.8,4.2,0.0,161753,35260,0,782816,220175,0,VACSI
2021-03-30,2021,13,REG,32,Hauts-de-France,16.4,5.3,0.0,125325,60188,0,908141,280363,0,VACSI
2021-04-06,2021,14,REG,32,Hauts-de-France,19.2,6.6,0.0,137567,91311,0,1045708,371674,0,VACSI
2021-04-13,2021,15,REG,32,Hauts-de-France,21.9,8.3,0.0,132476,94374,0,1178184,466048,0,VACSI
2021-04-20,2021,16,REG,32,Hauts-de-France,24.0,10.0,0.0,107883,101000,0,1286067,567048,0,VACSI
2021-04-27,2021,17,REG,32,Hauts-de-France,26.3,12.3,0.0,154667,108799,0,1440734,675847,0,VACSI
2021-05-04,2021,18,REG,32,Hauts-de-France,29.7,14.4,0.0,192834,108929,0,1633568,784776,0,VACSI
2021-05-11,2021,19,REG,32,Hauts-de-France,34.2,16.2,0.0,286645,89188,0,1920213,873964,0,VACSI
2021-05-18,2021,20,REG,32,Hauts-de-France,39.9,17.8,0.0,277827,78567,0,2198040,952531,0,VACSI
2021-05-25,2021,21,REG,32,Hauts-de-France,45.2,19.7,0.0,215158,118449,0,2413198,1070980,0,VACSI
2021-06-01,2021,22,REG,32,Hauts-de-France,49.5,22.6,0.0,208924,148121,0,2622122,1219101,0,VACSI
2021-06-08,2021,23,REG,32,Hauts-de-France,53.0,25.8,0.0,155335,188479,0,2777457,1407580,0,VACSI
2021-06-15,2021,24,REG,32,Hauts-de-France,55.7,30.2,0.0,128546,244534,0,2906003,1652114,0,VACSI
2021-06-22,2021,25,REG,32,Hauts-de-France,57.7,35.6,0.0,93112,316708,3,2999115,1968822,3,VACSI
2021-06-29,2021,26,REG,32,Hauts-de-France,59.6,42.0,0.0,95914,312874,0,3095029,2281696,3,VACSI
2021-07-06,2021,27,REG,32,Hauts-de-France,61.6,47.8,0.0,109152,267021,8,3204181,2548717,11,VACSI
2021-07-13,2021,28,REG,32,Hauts-de-France,64.4,53.0,0.0,180995,249971,0,3385176,2798688,11,VACSI
2021-07-20,2021,29,REG,32,Hauts-de-France,68.8,57.8,0.0,245083,229675,0,3630259,3028363,11,VACSI
2021-07-27,2021,30,REG,32,Hauts-de-France,74.1,61.4,0.0,241158,170203,0,3871417,3198566,11,VACSI
2021-08-03,2021,31,REG,32,Hauts-de-France,78.2,64.3,0.0,178757,155861,0,4050174,3354427,11,VACSI
2021-08-10,2021,32,REG,32,Hauts-de-France,81.0,67.5,0.0,120884,175140,0,4171058,3529567,11,VACSI
2021-08-17,2021,33,REG,32,Hauts-de-France,83.0,71.7,0.0,85733,208791,0,4256791,3738358,11,VACSI
2021-08-24,2021,34,REG,32,Hauts-de-France,84.5,76.1,0.0,68287,214655,483,4325078,3953013,494,VACSI
2021-08-31,2021,35,REG,32,Hauts-de-France,85.7,79.4,0.1,49349,145816,11808,4374427,4098829,12302,VACSI
2021-09-07,2021,36,REG,32,Hauts-de-France,86.5,81.7,0.4,35337,97010,14518,4409764,4195839,26820,VACSI
2021-09-14,2021,37,REG,32,Hauts-de-France,87.2,83.3,0.9,30232,69868,23319,4439996,4265707,50139,VACSI
2021-09-21,2021,38,REG,32,Hauts-de-France,87.7,84.6,1.4,19217,51295,25553,4459213,4317002,75692,VACSI
2021-09-28,2021,39,REG,32,Hauts-de-France,88.0,85.5,1.9,18311,37719,27171,4477524,4354721,102863,VACSI
2021-10-05,2021,40,REG,32,Hauts-de-France,88.4,86.2,2.6,16898,31723,36227,4494422,4386444,139090,VACSI
2021-10-12,2021,41,REG,32,Hauts-de-France,88.7,86.7,3.4,15359,24731,43177,4509781,4411175,182267,VACSI
2021-10-19,2021,42,REG,32,Hauts-de-France,89.0,87.1,4.3,14135,19684,50726,4523916,4430859,232993,VACSI
2021-10-26,2021,43,REG,32,Hauts-de-France,89.3,87.5,5.4,10492,14116,45793,4534408,4444975,278786,VACSI
2021-11-02,2021,44,REG,32,Hauts-de-France,89.5,87.8,6.4,12584,17005,63695,4546992,4461980,342481,VACSI
2021-11-09,2021,45,REG,32,Hauts-de-France,89.6,88.1,7.6,10874,14246,74127,4557866,4476226,416608,VACSI
2021-11-16,2021,46,REG,32,Hauts-de-France,89.9,88.4,9.6,13830,14963,99971,4571696,4491189,516579,VACSI
2021-11-23,2021,47,REG,32,Hauts-de-France,90.1,88.6,12.0,13028,13940,168642,4584724,4505129,685221,VACSI
2021-11-30,2021,48,REG,32,Hauts-de-France,90.4,88.8,17.4,10685,13196,322682,4595409,4518325,1007903,VACSI
2021-12-07,2021,49,REG,32,Hauts-de-France,90.6,89.1,24.8,10772,14673,400191,4606181,4532998,1408094,VACSI
2021-12-14,2021,50,REG,32,Hauts-de-France,90.8,89.4,33.1,12684,15502,433109,4618865,4548500,1841203,VACSI
2021-12-21,2021,51,REG,32,Hauts-de-France,91.0,89.6,39.2,9948,9684,226006,4628813,4558184,2067209,VACSI
2021-12-28,2021,52,REG,32,Hauts-de-France,91.2,89.8,43.6,9169,8954,221424,4637982,4567138,2288633,VACSI
2022-01-04,2022,1,REG,32,Hauts-de-France,91.5,90.0,49.4,16031,15608,368033,4654013,4582746,2656666,VACSI
2022-01-11,2022,2,REG,32,Hauts-de-France,91.8,90.3,55.3,13519,13494,285836,4667532,4596240,2942502,VACSI
2022-01-18,2022,3,REG,32,Hauts-de-France,92.1,90.5,59.9,9069,10814,188742,4676601,4607054,3131244,VACSI
2022-01-25,2022,4,REG,32,Hauts-de-France,92.1,90.6,61.7,1137,1649,22727,4677738,4608703,3153971,VACSI
2020-12-22,2020,52,REG,44,Grand Est,0.0,0.0,0.0,17,0,0,17,0,0,VACSI
2020-12-29,2020,53,REG,44,Grand Est,0.0,0.0,0.0,341,1,0,358,1,0,VACSI
2021-01-05,2021,1,REG,44,Grand Est,0.15000000000000002,0.0,0.0,11766,43,0,12124,44,0,VACSI
2021-01-12,2021,2,REG,44,Grand Est,0.85,0.0,0.0,40675,239,0,52799,283,0,VACSI
2021-01-19,2021,3,REG,44,Grand Est,2.35,0.0,0.0,54883,584,0,107682,867,0,VACSI
2021-01-26,2021,4,REG,44,Grand Est,3.15,0.1,0.0,38989,7047,0,146671,7914,0,VACSI
2021-02-02,2021,5,REG,44,Grand Est,3.8,0.55,0.0,30880,26288,0,177551,34202,0,VACSI
2021-02-09,2021,6,REG,44,Grand Est,4.35,1.35,0.0,34573,33143,0,212124,67345,0,VACSI
2021-02-16,2021,7,REG,44,Grand Est,4.8,2.4,0.0,28354,44282,0,240478,111627,0,VACSI
2021-02-23,2021,8,REG,44,Grand Est,5.75,3.0999999999999996,0.0,51726,34611,0,292204,146238,0,VACSI
2021-03-02,2021,9,REG,44,Grand Est,6.9,3.75,0.0,94983,30926,0,387187,177164,0,VACSI
2021-03-09,2021,10,REG,44,Grand Est,9.0,4.300000000000001,0.0,122857,29498,0,510044,206662,0,VACSI
2021-03-16,2021,11,REG,44,Grand Est,11.25,4.75,0.0,96079,22333,0,606123,228995,0,VACSI
2021-03-23,2021,12,REG,44,Grand Est,14.3,5.05,0.0,134672,35285,0,740795,264280,0,VACSI
2021-03-30,2021,13,REG,44,Grand Est,17.0,5.85,0.0,99466,41809,0,840261,306089,0,VACSI
2021-04-06,2021,14,REG,44,Grand Est,19.75,7.25,0.0,128104,75816,0,968365,381905,0,VACSI
2021-04-13,2021,15,REG,44,Grand Est,23.2,9.1,0.0,140902,84239,0,1109267,466144,0,VACSI
2021-04-20,2021,16,REG,44,Grand Est,26.15,10.8,0.0,129365,86998,0,1238632,553142,0,VACSI
2021-04-27,2021,17,REG,44,Grand Est,29.200000000000003,12.85,0.0,152113,86510,1,1390745,639652,1,VACSI
2021-05-04,2021,18,REG,44,Grand Est,33.15,15.3,0.0,186098,112952,0,1576843,752604,1,VACSI
2021-05-11,2021,19,REG,44,Grand Est,37.35,18.45,0.0,217821,103872,0,1794664,856476,1,VACSI
2021-05-18,2021,20,REG,44,Grand Est,42.35,20.85,0.0,209397,86842,0,2004061,943318,1,VACSI
2021-05-25,2021,21,REG,44,Grand Est,46.05,22.7,0.0,194670,129619,0,2198731,1072937,1,VACSI
2021-06-01,2021,22,REG,44,Grand Est,49.900000000000006,25.549999999999997,0.0,200641,149133,0,2399372,1222070,1,VACSI
2021-06-08,2021,23,REG,44,Grand Est,53.5,29.05,0.0,184924,170375,1,2584296,1392445,2,VACSI
2021-06-15,2021,24,REG,44,Grand Est,56.75,33.6,0.0,137039,220738,0,2721335,1613183,2,VACSI
2021-06-22,2021,25,REG,44,Grand Est,59.0,38.35,0.0,99330,249511,7,2820665,1862694,9,VACSI
2021-06-29,2021,26,REG,44,Grand Est,60.599999999999994,43.7,0.0,86558,250040,18,2907223,2112734,27,VACSI
2021-07-06,2021,27,REG,44,Grand Est,62.25,48.35,0.0,92574,238963,37,2999797,2351697,64,VACSI
2021-07-13,2021,28,REG,44,Grand Est,64.7,53.150000000000006,0.0,136148,234031,1,3135945,2585728,65,VACSI
2021-07-20,2021,29,REG,44,Grand Est,68.44999999999999,57.8,0.0,180963,225331,1,3316908,2811059,66,VACSI
2021-07-27,2021,30,REG,44,Grand Est,72.9,61.2,0.0,223192,162370,1,3540100,2973429,67,VACSI
2021-08-03,2021,31,REG,44,Grand Est,76.80000000000001,64.0,0.0,168167,133211,6,3708267,3106640,73,VACSI
2021-08-10,2021,32,REG,44,Grand Est,79.6,67.1,0.0,95485,146809,1,3803752,3253449,74,VACSI
2021-08-17,2021,33,REG,44,Grand Est,81.45,70.6,0.0,66861,181647,3,3870613,3435096,77,VACSI
2021-08-24,2021,34,REG,44,Grand Est,83.0,74.3,0.0,57311,184458,451,3927924,3619554,528,VACSI
2021-08-31,2021,35,REG,44,Grand Est,84.19999999999999,78.05,0.2,44370,121103,11406,3972294,3740657,11934,VACSI
2021-09-07,2021,36,REG,44,Grand Est,85.0,80.1,0.5,33681,71824,15072,4005975,3812481,27006,VACSI
2021-09-14,2021,37,REG,44,Grand Est,85.7,81.55,1.0,27155,55343,24623,4033130,3867824,51629,VACSI
2021-09-21,2021,38,REG,44,Grand Est,86.1,82.69999999999999,1.5,17717,44006,25709,4050847,3911830,77338,VACSI
2021-09-28,2021,39,REG,44,Grand Est,86.5,83.6,2.05,17849,34379,28209,4068696,3946209,105547,VACSI
2021-10-05,2021,40,REG,44,Grand Est,86.85,84.4,2.8,16092,29288,33454,4084788,3975497,139001,VACSI
2021-10-12,2021,41,REG,44,Grand Est,87.15,85.05,3.55,15122,22713,38936,4099910,3998210,177937,VACSI
2021-10-19,2021,42,REG,44,Grand Est,87.35,85.5,4.5,13417,18450,43313,4113327,4016660,221250,VACSI
2021-10-26,2021,43,REG,44,Grand Est,87.6,85.75,5.5,10225,12745,40074,4123552,4029405,261324,VACSI
2021-11-02,2021,44,REG,44,Grand Est,87.75,86.05,6.55,11713,16409,60634,4135265,4045814,321958,VACSI
2021-11-09,2021,45,REG,44,Grand Est,87.9,86.35,8.149999999999999,9573,13785,76528,4144838,4059599,398486,VACSI
2021-11-16,2021,46,REG,44,Grand Est,88.1,86.55,10.4,11966,13784,105931,4156804,4073383,504417,VACSI
2021-11-23,2021,47,REG,44,Grand Est,88.4,86.80000000000001,13.350000000000001,13060,13602,160381,4169864,4086985,664798,VACSI
2021-11-30,2021,48,REG,44,Grand Est,88.6,87.0,18.8,11073,13075,278151,4180937,4100060,942949,VACSI
2021-12-07,2021,49,REG,44,Grand Est,88.75,87.30000000000001,25.85,12230,15061,350719,4193167,4115121,1293668,VACSI
2021-12-14,2021,50,REG,44,Grand Est,89.0,87.6,33.95,14326,17228,397918,4207493,4132349,1691586,VACSI
2021-12-21,2021,51,REG,44,Grand Est,89.25,87.80000000000001,39.85,10498,10486,209041,4217991,4142835,1900627,VACSI
2021-12-28,2021,52,REG,44,Grand Est,89.4,88.0,44.15,9825,10563,198156,4227816,4153398,2098783,VACSI
2022-01-04,2022,1,REG,44,Grand Est,89.7,88.3,50.15,17196,19479,345933,4245012,4172877,2444716,VACSI
2022-01-11,2022,2,REG,44,Grand Est,90.0,88.6,56.15,13527,16598,266979,4258539,4189475,2711695,VACSI
2022-01-18,2022,3,REG,44,Grand Est,90.2,88.8,60.2,8672,11878,165539,4267211,4201353,2877234,VACSI
2022-01-25,2022,4,REG,44,Grand Est,90.25,88.94999999999999,61.55,1067,2004,21388,4268278,4203357,2898622,VACSI
2020-12-22,2020,52,REG,52,Pays de la Loire,0.0,0.0,0.0,11,1,0,11,1,0,VACSI
2020-12-29,2020,53,REG,52,Pays de la Loire,0.0,0.0,0.0,55,3,0,66,4,0,VACSI
2021-01-05,2021,1,REG,52,Pays de la Loire,0.1,0.0,0.0,7124,15,0,7190,19,0,VACSI
2021-01-12,2021,2,REG,52,Pays de la Loire,0.6,0.0,0.0,17412,81,0,24602,100,0,VACSI
2021-01-19,2021,3,REG,52,Pays de la Loire,1.8,0.0,0.0,39242,185,0,63844,285,0,VACSI
2021-01-26,2021,4,REG,52,Pays de la Loire,2.8,0.0,0.0,33777,3476,0,97621,3761,0,VACSI
2021-02-02,2021,5,REG,52,Pays de la Loire,3.4,0.4,0.0,15350,11429,0,112971,15190,0,VACSI
2021-02-09,2021,6,REG,52,Pays de la Loire,4.1,1.2,0.0,20955,28127,0,133926,43317,0,VACSI
2021-02-16,2021,7,REG,52,Pays de la Loire,4.8,2.1,0.0,23246,33920,0,157172,77237,0,VACSI
2021-02-23,2021,8,REG,52,Pays de la Loire,5.6,2.7,0.0,25102,16978,0,182274,94215,0,VACSI
2021-03-02,2021,9,REG,52,Pays de la Loire,6.7,3.4,0.0,41480,19739,0,223754,113954,0,VACSI
2021-03-09,2021,10,REG,52,Pays de la Loire,8.7,4.0,0.0,66449,18864,0,290203,132818,0,VACSI
2021-03-16,2021,11,REG,52,Pays de la Loire,10.5,4.5,0.0,52830,12823,0,343033,145641,0,VACSI
2021-03-23,2021,12,REG,52,Pays de la Loire,13.3,4.9,0.0,85611,13900,0,428644,159541,0,VACSI
2021-03-30,2021,13,REG,52,Pays de la Loire,16.1,5.6,0.0,75143,16697,0,503787,176238,0,VACSI
2021-04-06,2021,14,REG,52,Pays de la Loire,18.8,6.4,0.0,105493,33345,0,609280,209583,0,VACSI
2021-04-13,2021,15,REG,52,Pays de la Loire,22.6,7.8,0.0,110579,43902,0,719859,253485,0,VACSI
2021-04-20,2021,16,REG,52,Pays de la Loire,25.3,9.5,0.0,105377,56711,0,825236,310196,0,VACSI
2021-04-27,2021,17,REG,52,Pays de la Loire,27.5,11.6,0.0,126224,64240,0,951460,374436,0,VACSI
2021-05-04,2021,18,REG,52,Pays de la Loire,31.9,14.0,0.0,120751,82708,0,1072211,457144,0,VACSI
2021-05-11,2021,19,REG,52,Pays de la Loire,36.6,16.5,0.0,135394,73667,0,1207605,530811,0,VACSI
2021-05-18,2021,20,REG,52,Pays de la Loire,41.2,19.0,0.0,142824,61449,0,1350429,592260,0,VACSI
2021-05-25,2021,21,REG,52,Pays de la Loire,45.7,21.0,0.0,151610,85264,0,1502039,677524,0,VACSI
2021-06-01,2021,22,REG,52,Pays de la Loire,50.4,23.5,0.0,158659,106342,0,1660698,783866,0,VACSI
2021-06-08,2021,23,REG,52,Pays de la Loire,55.1,26.2,0.0,145632,124086,0,1806330,907952,0,VACSI
2021-06-15,2021,24,REG,52,Pays de la Loire,58.2,31.3,0.0,126401,145919,1,1932731,1053871,1,VACSI
2021-06-22,2021,25,REG,52,Pays de la Loire,60.9,36.7,0.0,93853,168950,0,2026584,1222821,1,VACSI
2021-06-29,2021,26,REG,52,Pays de la Loire,63.2,42.3,0.0,77006,182794,13,2103590,1405615,14,VACSI
2021-07-06,2021,27,REG,52,Pays de la Loire,65.7,47.8,0.0,70472,192996,7,2174062,1598611,21,VACSI
2021-07-13,2021,28,REG,52,Pays de la Loire,68.2,53.3,0.0,92431,185007,6,2266493,1783618,27,VACSI
2021-07-20,2021,29,REG,52,Pays de la Loire,71.2,58.9,0.0,110720,189963,4,2377213,1973581,31,VACSI
2021-07-27,2021,30,REG,52,Pays de la Loire,75.5,63.1,0.0,148101,142634,3,2525314,2116215,34,VACSI
2021-08-03,2021,31,REG,52,Pays de la Loire,80.2,66.7,0.0,147285,109424,6,2672599,2225639,40,VACSI
2021-08-10,2021,32,REG,52,Pays de la Loire,84.3,69.9,0.0,109385,101333,5,2781984,2326972,45,VACSI
2021-08-17,2021,33,REG,52,Pays de la Loire,86.6,73.5,0.0,68471,128485,4,2850455,2455457,49,VACSI
2021-08-24,2021,34,REG,52,Pays de la Loire,88.1,77.9,0.0,47469,147373,245,2897924,2602830,294,VACSI
2021-08-31,2021,35,REG,52,Pays de la Loire,89.3,82.2,0.1,35221,123493,6992,2933145,2726323,7286,VACSI
2021-09-07,2021,36,REG,52,Pays de la Loire,90.0,85.1,0.5,22797,80360,10070,2955942,2806683,17356,VACSI
2021-09-14,2021,37,REG,52,Pays de la Loire,90.6,86.9,1.0,17203,52093,16760,2973145,2858776,34116,VACSI
2021-09-21,2021,38,REG,52,Pays de la Loire,91.0,88.2,1.6,12985,39891,19241,2986130,2898667,53357,VACSI
2021-09-28,2021,39,REG,52,Pays de la Loire,91.4,89.0,2.2,11195,26542,19388,2997325,2925209,72745,VACSI
2021-10-05,2021,40,REG,52,Pays de la Loire,91.7,89.7,2.8,9615,19088,20501,3006940,2944297,93246,VACSI
2021-10-12,2021,41,REG,52,Pays de la Loire,91.9,90.2,3.5,8528,14613,22937,3015468,2958910,116183,VACSI
2021-10-19,2021,42,REG,52,Pays de la Loire,92.2,90.6,4.3,7852,12771,27239,3023320,2971681,143422,VACSI
2021-10-26,2021,43,REG,52,Pays de la Loire,92.4,90.9,5.4,5714,7930,25294,3029034,2979611,168716,VACSI
2021-11-02,2021,44,REG,52,Pays de la Loire,92.6,91.1,6.4,6748,9307,40244,3035782,2988918,208960,VACSI
2021-11-09,2021,45,REG,52,Pays de la Loire,92.8,91.4,7.9,5318,7645,48558,3041100,2996563,257518,VACSI
2021-11-16,2021,46,REG,52,Pays de la Loire,93.0,91.6,10.1,7111,7824,72578,3048211,3004387,330096,VACSI
2021-11-23,2021,47,REG,52,Pays de la Loire,93.2,91.9,12.8,7937,7963,107016,3056148,3012350,437112,VACSI
2021-11-30,2021,48,REG,52,Pays de la Loire,93.4,92.1,17.6,5546,6357,171032,3061694,3018707,608144,VACSI
2021-12-07,2021,49,REG,52,Pays de la Loire,93.6,92.3,24.5,5478,7634,225238,3067172,3026341,833382,VACSI
2021-12-14,2021,50,REG,52,Pays de la Loire,93.8,92.6,32.5,6856,9186,274444,3074028,3035527,1107826,VACSI
2021-12-21,2021,51,REG,52,Pays de la Loire,94.0,92.8,38.6,6096,5573,162777,3080124,3041100,1270603,VACSI
2021-12-28,2021,52,REG,52,Pays de la Loire,94.1,92.9,42.9,5193,4572,147264,3085317,3045672,1417867,VACSI
2022-01-04,2022,1,REG,52,Pays de la Loire,94.4,93.1,50.1,9603,8908,266132,3094920,3054580,1683999,VACSI
2022-01-11,2022,2,REG,52,Pays de la Loire,94.5,93.4,57.2,5137,7185,227361,3100057,3061765,1911360,VACSI
2022-01-18,2022,3,REG,52,Pays de la Loire,94.7,93.5,62.5,3274,5661,149673,3103331,3067426,2061033,VACSI
2022-01-25,2022,4,REG,52,Pays de la Loire,94.7,93.6,64.3,401,1045,20247,3103732,3068471,2081280,VACSI
2020-12-22,2020,52,REG,53,Bretagne,0.0,0.0,0.0,4,0,0,4,0,0,VACSI
2020-12-29,2020,53,REG,53,Bretagne,0.0,0.0,0.0,72,0,0,76,0,0,VACSI
2021-01-05,2021,1,REG,53,Bretagne,0.1,0.0,0.0,4417,10,0,4493,10,0,VACSI
2021-01-12,2021,2,REG,53,Bretagne,0.6,0.0,0.0,18173,109,0,22666,119,0,VACSI
2021-01-19,2021,3,REG,53,Bretagne,1.8499999999999999,0.0,0.0,39377,173,0,62043,292,0,VACSI
2021-01-26,2021,4,REG,53,Bretagne,3.0,0.1,0.0,25769,3065,0,87812,3357,0,VACSI
2021-02-02,2021,5,REG,53,Bretagne,3.7,0.45,0.0,22046,10504,0,109858,13861,0,VACSI
2021-02-09,2021,6,REG,53,Bretagne,4.5,1.2000000000000002,0.0,22719,28481,0,132577,42342,0,VACSI
2021-02-16,2021,7,REG,53,Bretagne,5.3,2.25,0.0,23214,23331,0,155791,65673,0,VACSI
2021-02-23,2021,8,REG,53,Bretagne,6.4,2.9,0.0,32064,22414,0,187855,88087,0,VACSI
2021-03-02,2021,9,REG,53,Bretagne,7.85,3.7,0.0,44891,21842,0,232746,109929,0,VACSI
2021-03-09,2021,10,REG,53,Bretagne,10.05,4.3,0.0,67949,16924,0,300695,126853,0,VACSI
2021-03-16,2021,11,REG,53,Bretagne,11.8,4.949999999999999,0.0,51156,17454,0,351851,144307,0,VACSI
2021-03-23,2021,12,REG,53,Bretagne,14.55,5.55,0.0,82768,17780,0,434619,162087,0,VACSI
2021-03-30,2021,13,REG,53,Bretagne,17.4,6.3,0.0,73239,19438,0,507858,181525,0,VACSI
2021-04-06,2021,14,REG,53,Bretagne,20.4,7.1,0.0,100290,29424,0,608148,210949,0,VACSI
2021-04-13,2021,15,REG,53,Bretagne,24.85,8.25,0.0,117848,40708,0,725996,251657,0,VACSI
2021-04-20,2021,16,REG,53,Bretagne,28.65,9.850000000000001,0.0,104175,51830,0,830171,303487,0,VACSI
2021-04-27,2021,17,REG,53,Bretagne,32.95,11.9,0.0,108920,58330,1,939091,361817,1,VACSI
2021-05-04,2021,18,REG,53,Bretagne,36.5,14.7,0.0,93968,82281,0,1033059,444098,1,VACSI
2021-05-11,2021,19,REG,53,Bretagne,39.85,17.35,0.0,106294,68113,0,1139353,512211,1,VACSI
2021-05-18,2021,20,REG,53,Bretagne,43.75,20.35,0.0,121641,60750,0,1260994,572961,1,VACSI
2021-05-25,2021,21,REG,53,Bretagne,47.6,23.049999999999997,0.0,121856,85256,0,1382850,658217,1,VACSI
2021-06-01,2021,22,REG,53,Bretagne,52.400000000000006,26.15,0.0,138152,96942,0,1521002,755159,1,VACSI
2021-06-08,2021,23,REG,53,Bretagne,57.75,29.5,0.0,144978,101643,1,1665980,856802,2,VACSI
2021-06-15,2021,24,REG,53,Bretagne,61.85,33.75,0.0,119100,119304,0,1785080,976106,2,VACSI
2021-06-22,2021,25,REG,53,Bretagne,64.9,38.35,0.0,89240,141153,0,1874320,1117259,2,VACSI
2021-06-29,2021,26,REG,53,Bretagne,66.94999999999999,43.400000000000006,0.0,70579,159727,2,1944899,1276986,4,VACSI
2021-07-06,2021,27,REG,53,Bretagne,69.19999999999999,48.900000000000006,0.0,64197,165340,2,2009096,1442326,6,VACSI
2021-07-13,2021,28,REG,53,Bretagne,71.85,54.5,0.0,77437,158674,3,2086533,1601000,9,VACSI
2021-07-20,2021,29,REG,53,Bretagne,75.1,60.85,0.0,90241,173551,0,2176774,1774551,9,VACSI
2021-07-27,2021,30,REG,53,Bretagne,78.6,65.9,0.0,108674,136585,0,2285448,1911136,9,VACSI
2021-08-03,2021,31,REG,53,Bretagne,82.7,69.5,0.0,117468,103779,1,2402916,2014915,10,VACSI
2021-08-10,2021,32,REG,53,Bretagne,85.95,72.6,0.0,90644,92659,2,2493560,2107574,12,VACSI
2021-08-17,2021,33,REG,53,Bretagne,88.55,75.85,0.0,72020,101716,3,2565580,2209290,15,VACSI
2021-08-24,2021,34,REG,53,Bretagne,90.1,79.65,0.0,41201,114433,323,2606781,2323723,338,VACSI
2021-08-31,2021,35,REG,53,Bretagne,91.15,83.05,0.2,29689,96628,6451,2636470,2420351,6789,VACSI
2021-09-07,2021,36,REG,53,Bretagne,91.95,85.75,0.5,20891,78124,10156,2657361,2498475,16945,VACSI
2021-09-14,2021,37,REG,53,Bretagne,92.6,87.9,1.15,16985,56898,19152,2674346,2555373,36097,VACSI
2021-09-21,2021,38,REG,53,Bretagne,93.0,89.44999999999999,1.9,10850,38580,20942,2685196,2593953,57039,VACSI
2021-09-28,2021,39,REG,53,Bretagne,93.35,90.55,2.6,8908,25840,19251,2694104,2619793,76290,VACSI
2021-10-05,2021,40,REG,53,Bretagne,93.6,91.35,3.3,7819,20124,20135,2701923,2639917,96425,VACSI
2021-10-12,2021,41,REG,53,Bretagne,93.80000000000001,91.9,4.0,7183,14323,22000,2709106,2654240,118425,VACSI
2021-10-19,2021,42,REG,53,Bretagne,94.05,92.25,4.800000000000001,6184,10634,26515,2715290,2664874,144940,VACSI
2021-10-26,2021,43,REG,53,Bretagne,94.25,92.55,5.75,4783,6864,23813,2720073,2671738,168753,VACSI
2021-11-02,2021,44,REG,53,Bretagne,94.4,92.8,6.7,5533,8052,38211,2725606,2679790,206964,VACSI
2021-11-09,2021,45,REG,53,Bretagne,94.55,93.0,8.15,4535,6518,45587,2730141,2686308,252551,VACSI
2021-11-16,2021,46,REG,53,Bretagne,94.75,93.3,10.7,6486,6613,72175,2736627,2692921,324726,VACSI
2021-11-23,2021,47,REG,53,Bretagne,94.95,93.5,14.0,6321,6345,98959,2742948,2699266,423685,VACSI
2021-11-30,2021,48,REG,53,Bretagne,95.15,93.7,19.4,4928,5991,169996,2747876,2705257,593681,VACSI
2021-12-07,2021,49,REG,53,Bretagne,95.4,93.9,26.75,5407,7300,227875,2753283,2712557,821556,VACSI
2021-12-14,2021,50,REG,53,Bretagne,95.6,94.2,35.8,6545,8147,262144,2759828,2720704,1083700,VACSI
2021-12-21,2021,51,REG,53,Bretagne,95.8,94.4,42.150000000000006,5127,5097,141550,2764955,2725801,1225250,VACSI
2021-12-28,2021,52,REG,53,Bretagne,96.0,94.6,46.75,4773,4602,134698,2769728,2730403,1359948,VACSI
2022-01-04,2022,1,REG,53,Bretagne,96.25,94.9,53.95,9207,8523,240311,2778935,2738926,1600259,VACSI
2022-01-11,2022,2,REG,53,Bretagne,96.55,95.15,61.4,7227,7436,192844,2786162,2746362,1793103,VACSI
2022-01-18,2022,3,REG,53,Bretagne,96.75,95.4,66.35,5058,6168,128362,2791220,2752530,1921465,VACSI
2022-01-25,2022,4,REG,53,Bretagne,96.80000000000001,95.5,68.05,629,1022,16718,2791849,2753552,1938183,VACSI
2020-12-22,2020,52,REG,75,Nouvelle-Aquitaine,0.0,0.0,0.0,22,0,0,22,0,0,VACSI
2020-12-29,2020,53,REG,75,Nouvelle-Aquitaine,0.0,0.0,0.0,148,1,0,170,1,0,VACSI
2021-01-05,2021,1,REG,75,Nouvelle-Aquitaine,0.2,0.0,0.0,16040,46,0,16210,47,0,VACSI
2021-01-12,2021,2,REG,75,Nouvelle-Aquitaine,0.9,0.0,0.0,36820,267,0,53030,314,0,VACSI
2021-01-19,2021,3,REG,75,Nouvelle-Aquitaine,2.3499999999999996,0.0,0.0,72822,491,0,125852,805,0,VACSI
2021-01-26,2021,4,REG,75,Nouvelle-Aquitaine,3.45,0.1,0.0,56133,10348,0,181985,11153,0,VACSI
2021-02-02,2021,5,REG,75,Nouvelle-Aquitaine,4.199999999999999,0.6,0.0,45112,24609,0,227097,35762,0,VACSI
2021-02-09,2021,6,REG,75,Nouvelle-Aquitaine,5.15,1.4,0.0,36390,44996,0,263487,80758,0,VACSI
2021-02-16,2021,7,REG,75,Nouvelle-Aquitaine,5.75,2.55,0.0,25148,55237,0,288635,135995,0,VACSI
2021-02-23,2021,8,REG,75,Nouvelle-Aquitaine,6.449999999999999,3.4,0.0,45004,51370,0,333639,187365,0,VACSI
2021-03-02,2021,9,REG,75,Nouvelle-Aquitaine,8.0,4.3,0.0,84841,39785,0,418480,227150,0,VACSI
2021-03-09,2021,10,REG,75,Nouvelle-Aquitaine,10.100000000000001,5.05,0.0,126292,30099,0,544772,257249,0,VACSI
2021-03-16,2021,11,REG,75,Nouvelle-Aquitaine,12.05,5.4,0.0,99840,21534,0,644612,278783,0,VACSI
2021-03-23,2021,12,REG,75,Nouvelle-Aquitaine,15.15,5.85,0.0,165849,23358,0,810461,302141,0,VACSI
2021-03-30,2021,13,REG,75,Nouvelle-Aquitaine,18.35,6.699999999999999,0.0,148290,29933,0,958751,332074,0,VACSI
2021-04-06,2021,14,REG,75,Nouvelle-Aquitaine,21.55,7.65,0.0,200910,63374,0,1159661,395448,0,VACSI
2021-04-13,2021,15,REG,75,Nouvelle-Aquitaine,25.25,9.100000000000001,0.0,188326,83234,0,1347987,478682,0,VACSI
2021-04-20,2021,16,REG,75,Nouvelle-Aquitaine,28.55,10.9,0.0,158107,105943,0,1506094,584625,0,VACSI
2021-04-27,2021,17,REG,75,Nouvelle-Aquitaine,32.6,13.4,0.0,184057,128517,0,1690151,713142,0,VACSI
2021-05-04,2021,18,REG,75,Nouvelle-Aquitaine,36.1,16.799999999999997,0.0,184582,165785,0,1874733,878927,0,VACSI
2021-05-11,2021,19,REG,75,Nouvelle-Aquitaine,39.45,19.15,0.0,190256,122779,0,2064989,1001706,0,VACSI
2021-05-18,2021,20,REG,75,Nouvelle-Aquitaine,44.3,21.200000000000003,0.0,222958,94323,0,2287947,1096029,0,VACSI
2021-05-25,2021,21,REG,75,Nouvelle-Aquitaine,48.05,23.6,0.0,214382,144339,0,2502329,1240368,0,VACSI
2021-06-01,2021,22,REG,75,Nouvelle-Aquitaine,52.05,26.6,0.0,238297,178533,0,2740626,1418901,0,VACSI
2021-06-08,2021,23,REG,75,Nouvelle-Aquitaine,55.55,30.35,0.0,213919,203863,0,2954545,1622764,0,VACSI
2021-06-15,2021,24,REG,75,Nouvelle-Aquitaine,58.55,34.7,0.0,182337,226451,1,3136882,1849215,1,VACSI
2021-06-22,2021,25,REG,75,Nouvelle-Aquitaine,60.8,39.3,0.0,132524,245513,0,3269406,2094728,1,VACSI
2021-06-29,2021,26,REG,75,Nouvelle-Aquitaine,62.900000000000006,44.4,0.0,107602,275791,0,3377008,2370519,1,VACSI
2021-07-06,2021,27,REG,75,Nouvelle-Aquitaine,65.0,49.349999999999994,0.0,106241,281307,5,3483249,2651826,6,VACSI
2021-07-13,2021,28,REG,75,Nouvelle-Aquitaine,67.15,54.1,0.0,127655,267967,1,3610904,2919793,7,VACSI
2021-07-20,2021,29,REG,75,Nouvelle-Aquitaine,70.4,58.65,0.0,178272,270926,0,3789176,3190719,7,VACSI
2021-07-27,2021,30,REG,75,Nouvelle-Aquitaine,74.4,62.95,0.0,220215,206709,0,4009391,3397428,7,VACSI
2021-08-03,2021,31,REG,75,Nouvelle-Aquitaine,78.55000000000001,66.05,0.0,211524,151798,0,4220915,3549226,7,VACSI
2021-08-10,2021,32,REG,75,Nouvelle-Aquitaine,81.69999999999999,68.94999999999999,0.0,156793,153389,2,4377708,3702615,9,VACSI
2021-08-17,2021,33,REG,75,Nouvelle-Aquitaine,84.05,72.35,0.0,98352,187852,1,4476060,3890467,10,VACSI
2021-08-24,2021,34,REG,75,Nouvelle-Aquitaine,85.44999999999999,76.35,0.0,65449,210558,362,4541509,4101025,372,VACSI
2021-08-31,2021,35,REG,75,Nouvelle-Aquitaine,86.44999999999999,79.95,0.2,49688,175170,14065,4591197,4276195,14437,VACSI
2021-09-07,2021,36,REG,75,Nouvelle-Aquitaine,87.15,82.19999999999999,0.55,35134,115947,22352,4626331,4392142,36789,VACSI
2021-09-14,2021,37,REG,75,Nouvelle-Aquitaine,87.75,83.94999999999999,1.3,28749,75625,35682,4655080,4467767,72471,VACSI
2021-09-21,2021,38,REG,75,Nouvelle-Aquitaine,88.15,85.2,1.95,19162,56444,34938,4674242,4524211,107409,VACSI
2021-09-28,2021,39,REG,75,Nouvelle-Aquitaine,88.44999999999999,86.05,2.55,16973,38223,33514,4691215,4562434,140923,VACSI
2021-10-05,2021,40,REG,75,Nouvelle-Aquitaine,88.75,86.75,3.4,14635,31467,37604,4705850,4593901,178527,VACSI
2021-10-12,2021,41,REG,75,Nouvelle-Aquitaine,89.0,87.19999999999999,4.25,13567,23971,44321,4719417,4617872,222848,VACSI
2021-10-19,2021,42,REG,75,Nouvelle-Aquitaine,89.25,87.6,5.2,12438,19315,51399,4731855,4637187,274247,VACSI
2021-10-26,2021,43,REG,75,Nouvelle-Aquitaine,89.44999999999999,87.85,6.2,9152,12698,50280,4741007,4649885,324527,VACSI
2021-11-02,2021,44,REG,75,Nouvelle-Aquitaine,89.6,88.1,7.35,10303,14732,72421,4751310,4664617,396948,VACSI
2021-11-09,2021,45,REG,75,Nouvelle-Aquitaine,89.75,88.35,9.05,8629,12259,85184,4759939,4676876,482132,VACSI
2021-11-16,2021,46,REG,75,Nouvelle-Aquitaine,89.94999999999999,88.6,11.350000000000001,11505,12953,125556,4771444,4689829,607688,VACSI
2021-11-23,2021,47,REG,75,Nouvelle-Aquitaine,90.15,88.80000000000001,14.350000000000001,12449,12603,179997,4783893,4702432,787685,VACSI
2021-11-30,2021,48,REG,75,Nouvelle-Aquitaine,90.35,89.0,19.299999999999997,10309,11842,293862,4794202,4714274,1081547,VACSI
2021-12-07,2021,49,REG,75,Nouvelle-Aquitaine,90.5,89.19999999999999,26.5,10504,13231,388562,4804706,4727505,1470109,VACSI
2021-12-14,2021,50,REG,75,Nouvelle-Aquitaine,90.7,89.5,34.55,13359,16200,459336,4818065,4743705,1929445,VACSI
2021-12-21,2021,51,REG,75,Nouvelle-Aquitaine,90.9,89.69999999999999,40.8,11041,10567,261815,4829106,4754272,2191260,VACSI
2021-12-28,2021,52,REG,75,Nouvelle-Aquitaine,91.05,89.80000000000001,44.95,10321,9488,233669,4839427,4763760,2424929,VACSI
2022-01-04,2022,1,REG,75,Nouvelle-Aquitaine,91.35,90.05000000000001,51.45,19078,17408,398295,4858505,4781168,2823224,VACSI
2022-01-11,2022,2,REG,75,Nouvelle-Aquitaine,91.65,90.3,57.8,16419,15588,315873,4874924,4796756,3139097,VACSI
2022-01-18,2022,3,REG,75,Nouvelle-Aquitaine,91.9,90.5,62.3,10151,12358,194304,4885075,4809114,3333401,VACSI
2022-01-25,2022,4,REG,75,Nouvelle-Aquitaine,91.94999999999999,90.6,63.7,1366,2021,27023,4886441,4811135,3360424,VACSI
2020-12-22,2020,52,REG,76,Occitanie,0.0,0.0,0.0,13,0,0,13,0,0,VACSI
2020-12-29,2020,53,REG,76,Occitanie,0.0,0.0,0.0,120,1,0,133,1,0,VACSI
2021-01-05,2021,1,REG,76,Occitanie,0.1,0.0,0.0,12506,38,0,12639,39,0,VACSI
2021-01-12,2021,2,REG,76,Occitanie,0.8,0.0,0.0,38788,247,0,51427,286,0,VACSI
2021-01-19,2021,3,REG,76,Occitanie,2.1,0.0,0.0,66497,383,0,117924,669,0,VACSI
2021-01-26,2021,4,REG,76,Occitanie,3.6,0.1,0.0,49781,7981,0,167705,8650,0,VACSI
2021-02-02,2021,5,REG,76,Occitanie,4.4,0.6,0.0,46215,24904,0,213920,33554,0,VACSI
2021-02-09,2021,6,REG,76,Occitanie,5.0,1.4,0.0,37495,43777,0,251415,77331,0,VACSI
2021-02-16,2021,7,REG,76,Occitanie,5.5,2.5,0.0,24747,47911,0,276162,125242,0,VACSI
2021-02-23,2021,8,REG,76,Occitanie,6.4,3.6,0.0,37175,48742,0,313337,173984,0,VACSI
2021-03-02,2021,9,REG,76,Occitanie,7.6,4.5,0.0,85148,38625,0,398485,212609,0,VACSI
2021-03-09,2021,10,REG,76,Occitanie,9.7,4.9,0.0,112030,31478,0,510515,244087,0,VACSI
2021-03-16,2021,11,REG,76,Occitanie,11.5,5.4,0.0,85129,22892,0,595644,266979,0,VACSI
2021-03-23,2021,12,REG,76,Occitanie,14.4,6.0,0.0,151425,24402,0,747069,291381,0,VACSI
2021-03-30,2021,13,REG,76,Occitanie,17.5,6.6,0.0,140846,27968,0,887915,319349,0,VACSI
2021-04-06,2021,14,REG,76,Occitanie,20.2,7.5,0.0,176071,56984,0,1063986,376333,0,VACSI
2021-04-13,2021,15,REG,76,Occitanie,24.5,9.1,0.0,188965,76033,0,1252951,452366,0,VACSI
2021-04-20,2021,16,REG,76,Occitanie,27.9,11.1,0.0,157110,100989,0,1410061,553355,0,VACSI
2021-04-27,2021,17,REG,76,Occitanie,30.5,13.2,0.0,164904,114434,0,1574965,667789,0,VACSI
2021-05-04,2021,18,REG,76,Occitanie,34.0,17.2,0.0,170847,159782,0,1745812,827571,0,VACSI
2021-05-11,2021,19,REG,76,Occitanie,37.2,20.3,0.0,192515,126812,0,1938327,954383,0,VACSI
2021-05-18,2021,20,REG,76,Occitanie,41.8,22.2,0.0,205486,89570,0,2143813,1043953,0,VACSI
2021-05-25,2021,21,REG,76,Occitanie,45.8,23.7,0.0,185674,137227,0,2329487,1181180,0,VACSI
2021-06-01,2021,22,REG,76,Occitanie,49.5,26.8,0.0,199157,177501,0,2528644,1358681,0,VACSI
2021-06-08,2021,23,REG,76,Occitanie,52.9,30.1,0.0,187069,186883,0,2715713,1545564,0,VACSI
2021-06-15,2021,24,REG,76,Occitanie,55.3,34.0,0.0,153402,217346,0,2869115,1762910,0,VACSI
2021-06-22,2021,25,REG,76,Occitanie,57.1,38.3,0.0,102110,237583,0,2971225,2000493,0,VACSI
2021-06-29,2021,26,REG,76,Occitanie,59.2,43.1,0.0,97927,248721,1,3069152,2249214,1,VACSI
2021-07-06,2021,27,REG,76,Occitanie,60.7,48.0,0.0,98407,240275,20,3167559,2489489,21,VACSI
2021-07-13,2021,28,REG,76,Occitanie,62.9,52.3,0.0,155092,228798,1,3322651,2718287,22,VACSI
2021-07-20,2021,29,REG,76,Occitanie,66.7,56.4,0.0,214880,236437,1,3537531,2954724,23,VACSI
2021-07-27,2021,30,REG,76,Occitanie,71.6,59.6,0.0,226184,172281,3,3763715,3127005,26,VACSI
2021-08-03,2021,31,REG,76,Occitanie,75.7,62.4,0.0,169634,148865,2,3933349,3275870,28,VACSI
2021-08-10,2021,32,REG,76,Occitanie,78.0,65.4,0.0,113315,171449,0,4046664,3447319,28,VACSI
2021-08-17,2021,33,REG,76,Occitanie,79.5,69.1,0.0,83077,196074,6,4129741,3643393,34,VACSI
2021-08-24,2021,34,REG,76,Occitanie,80.7,73.2,0.0,63684,188703,417,4193425,3832096,451,VACSI
2021-08-31,2021,35,REG,76,Occitanie,81.7,76.1,0.2,52726,134845,14451,4246151,3966941,14902,VACSI
2021-09-07,2021,36,REG,76,Occitanie,82.5,77.9,0.6,37203,88675,20337,4283354,4055616,35239,VACSI
2021-09-14,2021,37,REG,76,Occitanie,83.1,79.1,1.2,29529,64537,29464,4312883,4120153,64703,VACSI
2021-09-21,2021,38,REG,76,Occitanie,83.5,80.2,1.8,19957,52930,29398,4332840,4173083,94101,VACSI
2021-09-28,2021,39,REG,76,Occitanie,84.0,81.0,2.4,20115,38708,27357,4352955,4211791,121458,VACSI
2021-10-05,2021,40,REG,76,Occitanie,84.3,81.7,3.1,17265,32744,34607,4370220,4244535,156065,VACSI
2021-10-12,2021,41,REG,76,Occitanie,84.7,82.2,3.9,15804,24678,37438,4386024,4269213,193503,VACSI
2021-10-19,2021,42,REG,76,Occitanie,85.0,82.6,4.7,14234,21455,46803,4400258,4290668,240306,VACSI
2021-10-26,2021,43,REG,76,Occitanie,85.3,83.0,5.8,10627,14425,43127,4410885,4305093,283433,VACSI
2021-11-02,2021,44,REG,76,Occitanie,85.5,83.3,7.0,12135,16994,63291,4423020,4322087,346724,VACSI
2021-11-09,2021,45,REG,76,Occitanie,85.7,83.6,8.5,9819,13826,76733,4432839,4335913,423457,VACSI
2021-11-16,2021,46,REG,76,Occitanie,86.0,83.9,11.0,12763,14848,116318,4445602,4350761,539775,VACSI
2021-11-23,2021,47,REG,76,Occitanie,86.3,84.2,14.2,13891,14809,174290,4459493,4365570,714065,VACSI
2021-11-30,2021,48,REG,76,Occitanie,86.6,84.6,18.7,11657,13766,281827,4471150,4379336,995892,VACSI
2021-12-07,2021,49,REG,76,Occitanie,86.8,84.9,25.1,13290,16067,375527,4484440,4395403,1371419,VACSI
2021-12-14,2021,50,REG,76,Occitanie,87.0,85.3,33.1,16413,18981,416309,4500853,4414384,1787728,VACSI
2021-12-21,2021,51,REG,76,Occitanie,87.2,85.7,38.6,13331,12467,220325,4514184,4426851,2008053,VACSI
2021-12-28,2021,52,REG,76,Occitanie,87.4,86.0,41.9,12741,11887,203615,4526925,4438738,2211668,VACSI
2022-01-04,2022,1,REG,76,Occitanie,87.9,86.3,48.0,23517,22652,353844,4550442,4461390,2565512,VACSI
2022-01-11,2022,2,REG,76,Occitanie,88.4,86.6,53.6,18421,19493,263458,4568863,4480883,2828970,VACSI
2022-01-18,2022,3,REG,76,Occitanie,88.6,86.8,57.3,11746,15184,166648,4580609,4496067,2995618,VACSI
2022-01-25,2022,4,REG,76,Occitanie,88.7,86.9,58.6,1539,2594,23408,4582148,4498661,3019026,VACSI
2020-12-22,2020,52,REG,84,Auvergne-Rhône-Alpes,0.0,0.0,0.0,24,2,0,24,2,0,VACSI
2020-12-29,2020,53,REG,84,Auvergne-Rhône-Alpes,0.0,0.0,0.0,263,10,0,287,12,0,VACSI
2021-01-05,2021,1,REG,84,Auvergne-Rhône-Alpes,0.1,0.0,0.0,12902,66,0,13189,78,0,VACSI
2021-01-12,2021,2,REG,84,Auvergne-Rhône-Alpes,0.6,0.0,0.0,43558,230,0,56747,308,0,VACSI
2021-01-19,2021,3,REG,84,Auvergne-Rhône-Alpes,1.6,0.0,0.0,72896,522,0,129643,830,0,VACSI
2021-01-26,2021,4,REG,84,Auvergne-Rhône-Alpes,2.5,0.1,0.0,60430,6104,0,190073,6934,0,VACSI
2021-02-02,2021,5,REG,84,Auvergne-Rhône-Alpes,3.7,0.4,0.0,52804,24433,0,242877,31367,0,VACSI
2021-02-09,2021,6,REG,84,Auvergne-Rhône-Alpes,4.35,1.0,0.0,48473,46284,0,291350,77651,0,VACSI
2021-02-16,2021,7,REG,84,Auvergne-Rhône-Alpes,4.800000000000001,1.7,0.0,32495,56324,0,323845,133975,0,VACSI
2021-02-23,2021,8,REG,84,Auvergne-Rhône-Alpes,5.6,2.75,0.0,58054,57685,0,381899,191660,0,VACSI
2021-03-02,2021,9,REG,84,Auvergne-Rhône-Alpes,7.1,3.5,0.0,117463,45606,0,499362,237266,0,VACSI
2021-03-09,2021,10,REG,84,Auvergne-Rhône-Alpes,9.3,4.199999999999999,0.0,152010,41233,0,651372,278499,0,VACSI
2021-03-16,2021,11,REG,84,Auvergne-Rhône-Alpes,11.350000000000001,4.8,0.0,123408,33577,0,774780,312076,0,VACSI
2021-03-23,2021,12,REG,84,Auvergne-Rhône-Alpes,14.25,5.300000000000001,0.0,193175,39382,0,967955,351458,0,VACSI
2021-03-30,2021,13,REG,84,Auvergne-Rhône-Alpes,17.1,6.050000000000001,0.0,175241,56610,0,1143196,408068,0,VACSI
2021-04-06,2021,14,REG,84,Auvergne-Rhône-Alpes,19.799999999999997,7.1,0.0,200116,87924,0,1343312,495992,0,VACSI
2021-04-13,2021,15,REG,84,Auvergne-Rhône-Alpes,22.8,8.7,0.0,202245,110794,0,1545557,606786,0,VACSI
2021-04-20,2021,16,REG,84,Auvergne-Rhône-Alpes,25.75,10.5,0.0,172806,128248,0,1718363,735034,0,VACSI
2021-04-27,2021,17,REG,84,Auvergne-Rhône-Alpes,28.549999999999997,12.9,0.0,197904,147547,0,1916267,882581,0,VACSI
2021-05-04,2021,18,REG,84,Auvergne-Rhône-Alpes,31.8,15.600000000000001,0.0,244494,182978,0,2160761,1065559,0,VACSI
2021-05-11,2021,19,REG,84,Auvergne-Rhône-Alpes,36.15,17.85,0.0,331490,147656,0,2492251,1213215,0,VACSI
2021-05-18,2021,20,REG,84,Auvergne-Rhône-Alpes,41.55,20.15,0.0,334812,132821,0,2827063,1346036,0,VACSI
2021-05-25,2021,21,REG,84,Auvergne-Rhône-Alpes,45.650000000000006,22.5,0.0,302920,191682,0,3129983,1537718,0,VACSI
2021-06-01,2021,22,REG,84,Auvergne-Rhône-Alpes,49.25,25.4,0.0,304081,209433,1,3434064,1747151,1,VACSI
2021-06-08,2021,23,REG,84,Auvergne-Rhône-Alpes,52.400000000000006,28.7,0.0,235060,225305,0,3669124,1972456,1,VACSI
2021-06-15,2021,24,REG,84,Auvergne-Rhône-Alpes,54.900000000000006,32.8,0.0,184853,304525,0,3853977,2276981,1,VACSI
2021-06-22,2021,25,REG,84,Auvergne-Rhône-Alpes,57.25,38.1,0.0,129329,374024,1,3983306,2651005,2,VACSI
2021-06-29,2021,26,REG,84,Auvergne-Rhône-Alpes,59.150000000000006,43.599999999999994,0.0,136436,373474,1,4119742,3024479,3,VACSI
2021-07-06,2021,27,REG,84,Auvergne-Rhône-Alpes,61.2,47.95,0.0,143579,359530,1,4263321,3384009,4,VACSI
2021-07-13,2021,28,REG,84,Auvergne-Rhône-Alpes,64.15,52.9,0.0,231888,336886,0,4495209,3720895,4,VACSI
2021-07-20,2021,29,REG,84,Auvergne-Rhône-Alpes,68.1,57.3,0.0,298472,312326,3,4793681,4033221,7,VACSI
2021-07-27,2021,30,REG,84,Auvergne-Rhône-Alpes,72.55000000000001,61.25,0.0,311112,233087,4,5104793,4266308,11,VACSI
2021-08-03,2021,31,REG,84,Auvergne-Rhône-Alpes,76.55000000000001,64.35,0.0,222286,210601,3,5327079,4476909,14,VACSI
2021-08-10,2021,32,REG,84,Auvergne-Rhône-Alpes,79.19999999999999,67.55000000000001,0.0,151887,234229,0,5478966,4711138,14,VACSI
2021-08-17,2021,33,REG,84,Auvergne-Rhône-Alpes,81.15,71.0,0.0,113665,255737,0,5592631,4966875,14,VACSI
2021-08-24,2021,34,REG,84,Auvergne-Rhône-Alpes,82.6,74.9,0.0,92934,256943,582,5685565,5223818,596,VACSI
2021-08-31,2021,35,REG,84,Auvergne-Rhône-Alpes,83.9,78.1,0.2,81092,177157,16644,5766657,5400975,17240,VACSI
2021-09-07,2021,36,REG,84,Auvergne-Rhône-Alpes,84.75,80.05,0.5,54467,116247,23176,5821124,5517222,40416,VACSI
2021-09-14,2021,37,REG,84,Auvergne-Rhône-Alpes,85.44999999999999,81.44999999999999,1.0,40882,88913,34279,5862006,5606135,74695,VACSI
2021-09-21,2021,38,REG,84,Auvergne-Rhône-Alpes,85.85,82.65,1.55,26585,73447,34206,5888591,5679582,108901,VACSI
2021-09-28,2021,39,REG,84,Auvergne-Rhône-Alpes,86.25,83.5,2.1,29693,56222,36234,5918284,5735804,145135,VACSI
2021-10-05,2021,40,REG,84,Auvergne-Rhône-Alpes,86.7,84.19999999999999,2.75,24620,43591,44635,5942904,5779395,189770,VACSI
2021-10-12,2021,41,REG,84,Auvergne-Rhône-Alpes,86.94999999999999,84.69999999999999,3.5,22242,33753,51745,5965146,5813148,241515,VACSI
2021-10-19,2021,42,REG,84,Auvergne-Rhône-Alpes,87.25,85.15,4.35,19153,29106,61506,5984299,5842254,303021,VACSI
2021-10-26,2021,43,REG,84,Auvergne-Rhône-Alpes,87.44999999999999,85.5,5.4,14585,20940,57853,5998884,5863194,360874,VACSI
2021-11-02,2021,44,REG,84,Auvergne-Rhône-Alpes,87.65,85.8,6.45,16157,23890,87469,6015041,5887084,448343,VACSI
2021-11-09,2021,45,REG,84,Auvergne-Rhône-Alpes,87.80000000000001,86.1,7.95,13704,19793,104090,6028745,5906877,552433,VACSI
2021-11-16,2021,46,REG,84,Auvergne-Rhône-Alpes,88.05,86.45,10.2,17023,20810,148481,6045768,5927687,700914,VACSI
2021-11-23,2021,47,REG,84,Auvergne-Rhône-Alpes,88.30000000000001,86.75,13.0,17304,20151,215939,6063072,5947838,916853,VACSI
2021-11-30,2021,48,REG,84,Auvergne-Rhône-Alpes,88.5,87.0,18.0,13686,19574,365681,6076758,5967412,1282534,VACSI
2021-12-07,2021,49,REG,84,Auvergne-Rhône-Alpes,88.6,87.30000000000001,24.3,14394,21768,464343,6091152,5989180,1746877,VACSI
2021-12-14,2021,50,REG,84,Auvergne-Rhône-Alpes,88.85,87.6,32.45,18156,23752,569537,6109308,6012932,2316414,VACSI
2021-12-21,2021,51,REG,84,Auvergne-Rhône-Alpes,89.05,87.85,37.8,14816,15149,308779,6124124,6028081,2625193,VACSI
2021-12-28,2021,52,REG,84,Auvergne-Rhône-Alpes,89.25,88.0,41.55,12541,13571,277162,6136665,6041652,2902355,VACSI
2022-01-04,2022,1,REG,84,Auvergne-Rhône-Alpes,89.55,88.30000000000001,47.45,22375,23494,452090,6159040,6065146,3354445,VACSI
2022-01-11,2022,2,REG,84,Auvergne-Rhône-Alpes,89.75,88.5,52.849999999999994,11948,17353,367704,6170988,6082499,3722149,VACSI
2022-01-18,2022,3,REG,84,Auvergne-Rhône-Alpes,89.85,88.69999999999999,56.75,7612,13670,226544,6178600,6096169,3948693,VACSI
2022-01-25,2022,4,REG,84,Auvergne-Rhône-Alpes,89.85,88.75,58.0,929,2204,31173,6179529,6098373,3979866,VACSI
2020-12-22,2020,52,REG,93,Provence-Alpes-Côte d'Azur,0.0,0.0,0.0,40,0,0,40,0,0,VACSI
2020-12-29,2020,53,REG,93,Provence-Alpes-Côte d'Azur,0.0,0.0,0.0,287,4,0,327,4,0,VACSI
2021-01-05,2021,1,REG,93,Provence-Alpes-Côte d'Azur,0.1,0.0,0.0,6681,23,0,7008,27,0,VACSI
2021-01-12,2021,2,REG,93,Provence-Alpes-Côte d'Azur,0.6,0.0,0.0,28925,197,0,35933,224,0,VACSI
2021-01-19,2021,3,REG,93,Provence-Alpes-Côte d'Azur,1.7000000000000002,0.0,0.0,59249,378,0,95182,602,0,VACSI
2021-01-26,2021,4,REG,93,Provence-Alpes-Côte d'Azur,3.1,0.1,0.0,50327,4147,0,145509,4749,0,VACSI
2021-02-02,2021,5,REG,93,Provence-Alpes-Côte d'Azur,3.9,0.4,0.0,28918,16010,0,174427,20759,0,VACSI
2021-02-09,2021,6,REG,93,Provence-Alpes-Côte d'Azur,4.5,1.05,0.0,27579,33069,0,202006,53828,0,VACSI
2021-02-16,2021,7,REG,93,Provence-Alpes-Côte d'Azur,5.05,2.1,0.0,22444,44354,0,224450,98182,0,VACSI
2021-02-23,2021,8,REG,93,Provence-Alpes-Côte d'Azur,5.5,2.95,0.0,34151,32228,0,258601,130410,0,VACSI
2021-03-02,2021,9,REG,93,Provence-Alpes-Côte d'Azur,6.4,3.6,0.0,90434,32510,0,349035,162920,0,VACSI
2021-03-09,2021,10,REG,93,Provence-Alpes-Côte d'Azur,8.85,4.3,0.0,116206,27900,0,465241,190820,0,VACSI
2021-03-16,2021,11,REG,93,Provence-Alpes-Côte d'Azur,11.3,4.9,0.0,96388,23641,0,561629,214461,0,VACSI
2021-03-23,2021,12,REG,93,Provence-Alpes-Côte d'Azur,14.600000000000001,5.35,0.0,135230,29951,0,696859,244412,0,VACSI
2021-03-30,2021,13,REG,93,Provence-Alpes-Côte d'Azur,18.3,6.1,0.0,129881,38288,0,826740,282700,0,VACSI
2021-04-06,2021,14,REG,93,Provence-Alpes-Côte d'Azur,21.1,7.4,0.0,147150,74892,0,973890,357592,0,VACSI
2021-04-13,2021,15,REG,93,Provence-Alpes-Côte d'Azur,24.450000000000003,9.149999999999999,0.0,138772,88282,0,1112662,445874,0,VACSI
2021-04-20,2021,16,REG,93,Provence-Alpes-Côte d'Azur,27.15,11.45,0.0,122471,100077,0,1235133,545951,0,VACSI
2021-04-27,2021,17,REG,93,Provence-Alpes-Côte d'Azur,29.35,14.35,0.0,128120,106223,0,1363253,652174,0,VACSI
2021-05-04,2021,18,REG,93,Provence-Alpes-Côte d'Azur,31.75,16.95,0.0,120458,120765,0,1483711,772939,0,VACSI
2021-05-11,2021,19,REG,93,Provence-Alpes-Côte d'Azur,35.099999999999994,19.15,0.0,177979,100551,0,1661690,873490,0,VACSI
2021-05-18,2021,20,REG,93,Provence-Alpes-Côte d'Azur,38.9,21.35,0.0,163066,79794,0,1824756,953284,0,VACSI
2021-05-25,2021,21,REG,93,Provence-Alpes-Côte d'Azur,42.0,23.55,0.0,129167,127615,0,1953923,1080899,0,VACSI
2021-06-01,2021,22,REG,93,Provence-Alpes-Côte d'Azur,45.400000000000006,26.450000000000003,0.0,139928,144031,0,2093851,1224930,0,VACSI
2021-06-08,2021,23,REG,93,Provence-Alpes-Côte d'Azur,48.45,29.75,0.0,111042,147840,0,2204893,1372770,0,VACSI
2021-06-15,2021,24,REG,93,Provence-Alpes-Côte d'Azur,51.05,33.15,0.0,88568,156066,0,2293461,1528836,0,VACSI
2021-06-22,2021,25,REG,93,Provence-Alpes-Côte d'Azur,52.900000000000006,37.150000000000006,0.0,64576,189230,0,2358037,1718066,0,VACSI
2021-06-29,2021,26,REG,93,Provence-Alpes-Côte d'Azur,54.65,41.2,0.0,69973,178032,0,2428010,1896098,0,VACSI
2021-07-06,2021,27,REG,93,Provence-Alpes-Côte d'Azur,56.5,44.95,0.0,77537,156026,3,2505547,2052124,3,VACSI
2021-07-13,2021,28,REG,93,Provence-Alpes-Côte d'Azur,59.0,48.7,0.0,127576,166136,0,2633123,2218260,3,VACSI
2021-07-20,2021,29,REG,93,Provence-Alpes-Côte d'Azur,62.7,52.599999999999994,0.0,176415,156449,1,2809538,2374709,4,VACSI
2021-07-27,2021,30,REG,93,Provence-Alpes-Côte d'Azur,66.75,55.8,0.0,178450,118543,0,2987988,2493252,4,VACSI
2021-08-03,2021,31,REG,93,Provence-Alpes-Côte d'Azur,70.69999999999999,58.599999999999994,0.0,139949,111470,0,3127937,2604722,4,VACSI
2021-08-10,2021,32,REG,93,Provence-Alpes-Côte d'Azur,73.85,61.599999999999994,0.0,107805,133321,0,3235742,2738043,4,VACSI
2021-08-17,2021,33,REG,93,Provence-Alpes-Côte d'Azur,76.05000000000001,65.0,0.0,83007,152023,0,3318749,2890066,4,VACSI
2021-08-24,2021,34,REG,93,Provence-Alpes-Côte d'Azur,77.8,68.65,0.0,66513,146969,403,3385262,3037035,407,VACSI
2021-08-31,2021,35,REG,93,Provence-Alpes-Côte d'Azur,79.15,72.05,0.2,58788,117877,11060,3444050,3154912,11467,VACSI
2021-09-07,2021,36,REG,93,Provence-Alpes-Côte d'Azur,80.15,74.5,0.6,43622,87020,18995,3487672,3241932,30462,VACSI
2021-09-14,2021,37,REG,93,Provence-Alpes-Côte d'Azur,80.94999999999999,76.35,1.15,32670,64993,26233,3520342,3306925,56695,VACSI
2021-09-21,2021,38,REG,93,Provence-Alpes-Côte d'Azur,81.4,77.65,1.6,20856,55504,22917,3541198,3362429,79612,VACSI
2021-09-28,2021,39,REG,93,Provence-Alpes-Côte d'Azur,81.9,78.65,2.1,21745,40625,22235,3562943,3403054,101847,VACSI
2021-10-05,2021,40,REG,93,Provence-Alpes-Côte d'Azur,82.35,79.4,2.7,18693,34971,32839,3581636,3438025,134686,VACSI
2021-10-12,2021,41,REG,93,Provence-Alpes-Côte d'Azur,82.7,80.0,3.45,17266,27042,37967,3598902,3465067,172653,VACSI
2021-10-19,2021,42,REG,93,Provence-Alpes-Côte d'Azur,83.05,80.55,4.5,14762,22172,45485,3613664,3487239,218138,VACSI
2021-10-26,2021,43,REG,93,Provence-Alpes-Côte d'Azur,83.3,80.9,5.8,11189,15448,43179,3624853,3502687,261317,VACSI
2021-11-02,2021,44,REG,93,Provence-Alpes-Côte d'Azur,83.6,81.3,7.0,12795,18298,59825,3637648,3520985,321142,VACSI
2021-11-09,2021,45,REG,93,Provence-Alpes-Côte d'Azur,83.85,81.6,8.5,10861,15810,70889,3648509,3536795,392031,VACSI
2021-11-16,2021,46,REG,93,Provence-Alpes-Côte d'Azur,84.15,82.0,10.8,13638,16703,101299,3662147,3553498,493330,VACSI
2021-11-23,2021,47,REG,93,Provence-Alpes-Côte d'Azur,84.5,82.3,13.8,14621,16766,149822,3676768,3570264,643152,VACSI
2021-11-30,2021,48,REG,93,Provence-Alpes-Côte d'Azur,84.9,82.69999999999999,18.9,14174,16972,258322,3690942,3587236,901474,VACSI
2021-12-07,2021,49,REG,93,Provence-Alpes-Côte d'Azur,85.25,83.1,25.25,14898,19112,302860,3705840,3606348,1204334,VACSI
2021-12-14,2021,50,REG,93,Provence-Alpes-Côte d'Azur,85.65,83.6,32.25,17476,20910,310274,3723316,3627258,1514608,VACSI
2021-12-21,2021,51,REG,93,Provence-Alpes-Côte d'Azur,86.05,83.95,36.85,14059,14660,154983,3737375,3641918,1669591,VACSI
2021-12-28,2021,52,REG,93,Provence-Alpes-Côte d'Azur,86.3,84.25,39.8,13417,13726,142313,3750792,3655644,1811904,VACSI
2022-01-04,2022,1,REG,93,Provence-Alpes-Côte d'Azur,86.75,84.7,45.25,24061,25125,259534,3774853,3680769,2071438,VACSI
2022-01-11,2022,2,REG,93,Provence-Alpes-Côte d'Azur,87.15,85.25,50.599999999999994,18638,21892,196780,3793491,3702661,2268218,VACSI
2022-01-18,2022,3,REG,93,Provence-Alpes-Côte d'Azur,87.44999999999999,85.55,54.15,12084,16869,124035,3805575,3719530,2392253,VACSI
2022-01-25,2022,4,REG,93,Provence-Alpes-Côte d'Azur,87.55000000000001,85.75,55.349999999999994,1650,2813,17497,3807225,3722343,2409750,VACSI
2020-12-22,2020,52,REG,94,Corse,0.0,0.0,0.0,5,0,0,5,0,0,VACSI
2020-12-29,2020,53,REG,94,Corse,0.0,0.0,0.0,1,0,0,6,0,0,VACSI
2021-01-05,2021,1,REG,94,Corse,0.25,0.0,0.0,926,10,0,932,10,0,VACSI
2021-01-12,2021,2,REG,94,Corse,0.6499999999999999,0.0,0.0,1810,10,0,2742,20,0,VACSI
2021-01-19,2021,3,REG,94,Corse,1.95,0.0,0.0,4010,16,0,6752,36,0,VACSI
2021-01-26,2021,4,REG,94,Corse,3.0999999999999996,0.15000000000000002,0.0,3443,714,0,10195,750,0,VACSI
2021-02-02,2021,5,REG,94,Corse,4.25,0.55,0.0,3299,1307,0,13494,2057,0,VACSI
2021-02-09,2021,6,REG,94,Corse,5.25,1.35,0.0,3381,2321,0,16875,4378,0,VACSI
2021-02-16,2021,7,REG,94,Corse,6.25,2.2,0.0,2543,2777,0,19418,7155,0,VACSI
2021-02-23,2021,8,REG,94,Corse,6.85,3.15,0.0,2194,2946,0,21612,10101,0,VACSI
2021-03-02,2021,9,REG,94,Corse,8.25,4.15,0.0,7713,3131,0,29325,13232,0,VACSI
2021-03-09,2021,10,REG,94,Corse,11.45,5.1,0.0,7685,3170,0,37010,16402,0,VACSI
2021-03-16,2021,11,REG,94,Corse,13.7,6.05,0.0,7980,2537,0,44990,18939,0,VACSI
2021-03-23,2021,12,REG,94,Corse,17.049999999999997,6.65,0.0,10694,1980,0,55684,20919,0,VACSI
2021-03-30,2021,13,REG,94,Corse,20.35,7.85,0.0,9143,5434,0,64827,26353,0,VACSI
2021-04-06,2021,14,REG,94,Corse,23.799999999999997,9.850000000000001,0.0,12018,5203,0,76845,31556,0,VACSI
2021-04-13,2021,15,REG,94,Corse,27.55,11.8,0.0,10355,7256,0,87200,38812,0,VACSI
2021-04-20,2021,16,REG,94,Corse,30.75,14.55,0.0,9764,8556,0,96964,47368,0,VACSI
2021-04-27,2021,17,REG,94,Corse,34.5,17.4,0.0,11134,8822,0,108098,56190,0,VACSI
2021-05-04,2021,18,REG,94,Corse,38.0,20.9,0.0,9912,11103,0,118010,67293,0,VACSI
2021-05-11,2021,19,REG,94,Corse,40.75,23.6,0.0,8752,6675,0,126762,73968,0,VACSI
2021-05-18,2021,20,REG,94,Corse,43.45,25.5,0.0,6319,4333,0,133081,78301,0,VACSI
2021-05-25,2021,21,REG,94,Corse,44.95,27.95,0.0,4235,9081,0,137316,87382,0,VACSI
2021-06-01,2021,22,REG,94,Corse,46.2,31.2,0.0,3704,11184,0,141020,98566,0,VACSI
2021-06-08,2021,23,REG,94,Corse,47.45,35.150000000000006,0.0,3609,11353,0,144629,109919,0,VACSI
2021-06-15,2021,24,REG,94,Corse,48.45,38.349999999999994,0.0,3075,9323,0,147704,119242,0,VACSI
2021-06-22,2021,25,REG,94,Corse,49.3,41.15,0.0,2560,8811,0,150264,128053,0,VACSI
2021-06-29,2021,26,REG,94,Corse,50.2,43.7,0.0,2646,6581,0,152910,134634,0,VACSI
2021-07-06,2021,27,REG,94,Corse,51.3,45.7,0.0,3723,5241,0,156633,139875,0,VACSI
2021-07-13,2021,28,REG,94,Corse,54.2,47.35,0.0,10971,5105,0,167604,144980,0,VACSI
2021-07-20,2021,29,REG,94,Corse,58.1,49.05,0.0,11454,5037,0,179058,150017,0,VACSI
2021-07-27,2021,30,REG,94,Corse,61.5,50.65,0.0,9508,4571,0,188566,154588,0,VACSI
2021-08-03,2021,31,REG,94,Corse,64.0,52.7,0.0,6850,7631,0,195416,162219,0,VACSI
2021-08-10,2021,32,REG,94,Corse,65.9,55.85,0.0,5693,9644,0,201109,171863,0,VACSI
2021-08-17,2021,33,REG,94,Corse,67.5,58.900000000000006,0.0,4485,9146,0,205594,181009,0,VACSI
2021-08-24,2021,34,REG,94,Corse,68.7,61.599999999999994,0.0,3512,7639,42,209106,188648,42,VACSI
2021-08-31,2021,35,REG,94,Corse,69.8,63.8,0.2,2799,6139,829,211905,194787,871,VACSI
2021-09-07,2021,36,REG,94,Corse,70.44999999999999,65.55,0.6499999999999999,2190,4989,1333,214095,199776,2204,VACSI
2021-09-14,2021,37,REG,94,Corse,71.15,66.85,1.2,1808,3794,1875,215903,203570,4079,VACSI
2021-09-21,2021,38,REG,94,Corse,71.55000000000001,67.94999999999999,1.8,990,2978,1750,216893,206548,5829,VACSI
2021-09-28,2021,39,REG,94,Corse,71.85,68.7,2.3,1173,2058,1608,218066,208606,7437,VACSI
2021-10-05,2021,40,REG,94,Corse,72.15,69.3,2.9,943,1916,2258,219009,210522,9695,VACSI
2021-10-12,2021,41,REG,94,Corse,72.55000000000001,69.85,3.8,1007,1583,2841,220016,212105,12536,VACSI
2021-10-19,2021,42,REG,94,Corse,72.85,70.25,4.9,876,1214,3378,220892,213319,15914,VACSI
2021-10-26,2021,43,REG,94,Corse,73.05000000000001,70.65,6.15,603,956,3384,221495,214275,19298,VACSI
2021-11-02,2021,44,REG,94,Corse,73.30000000000001,70.95,7.35,781,1006,4500,222276,215281,23798,VACSI
2021-11-09,2021,45,REG,94,Corse,73.5,71.25,9.0,690,928,6060,222966,216209,29858,VACSI
2021-11-16,2021,46,REG,94,Corse,73.80000000000001,71.6,11.7,965,962,8406,223931,217171,38264,VACSI
2021-11-23,2021,47,REG,94,Corse,74.15,71.9,15.35,1096,1033,14576,225027,218204,52840,VACSI
2021-11-30,2021,48,REG,94,Corse,74.55,72.25,21.950000000000003,1182,1074,20596,226209,219278,73436,VACSI
2021-12-07,2021,49,REG,94,Corse,74.85,72.65,28.4,994,1321,18878,227203,220599,92314,VACSI
2021-12-14,2021,50,REG,94,Corse,75.25,73.1,34.5,1332,1547,17576,228535,222146,109890,VACSI
2021-12-21,2021,51,REG,94,Corse,75.69999999999999,73.6,38.1,946,1144,7698,229481,223290,117588,VACSI
2021-12-28,2021,52,REG,94,Corse,76.0,73.95,40.9,1099,1000,8780,230580,224290,126368,VACSI
2022-01-04,2022,1,REG,94,Corse,76.5,74.35,44.900000000000006,1627,1619,13928,232207,225909,140296,VACSI
2022-01-11,2022,2,REG,94,Corse,76.85,74.9,48.5,1056,1268,9717,233263,227177,150013,VACSI
2022-01-18,2022,3,REG,94,Corse,77.15,75.25,50.650000000000006,564,1068,4902,233827,228245,154915,VACSI
2022-01-25,2022,4,REG,94,Corse,77.2,75.4,51.349999999999994,65,170,651,233892,228415,155566,VACSI
2020-12-22,2020,52,REG,,,0.0,0.0,0.0,0,0,0,0,0,0,VACSI
2020-12-29,2020,53,REG,,,0.0,0.0,0.0,6,0,0,6,0,0,VACSI
2021-01-05,2021,1,REG,,,0.05,0.0,0.0,9,0,0,15,0,0,VACSI
2021-01-12,2021,2,REG,,,0.2,0.0,0.0,49,1,0,64,1,0,VACSI
2021-01-19,2021,3,REG,,,0.4,0.0,0.0,56,0,0,120,1,0,VACSI
2021-01-26,2021,4,REG,,,0.7000000000000001,0.0,0.0,69,5,0,189,6,0,VACSI
2021-02-02,2021,5,REG,,,1.1,0.05,0.0,116,10,0,305,16,0,VACSI
2021-02-09,2021,6,REG,,,1.7000000000000002,0.05,0.0,196,9,0,501,25,0,VACSI
2021-02-16,2021,7,REG,,,2.2,0.15000000000000002,0.0,147,11,0,648,36,0,VACSI
2021-02-23,2021,8,REG,,,2.8,0.5,0.0,228,107,0,876,143,0,VACSI
2021-03-02,2021,9,REG,,,3.6,0.95,0.0,250,117,0,1126,260,0,VACSI
2021-03-09,2021,10,REG,,,4.35,1.4,0.0,251,169,0,1377,429,0,VACSI
2021-03-16,2021,11,REG,,,5.5,1.9000000000000001,0.0,334,147,0,1711,576,0,VACSI
2021-03-23,2021,12,REG,,,6.75,2.35,0.0,480,199,0,2191,775,0,VACSI
2021-03-30,2021,13,REG,,,7.8999999999999995,3.0,0.0,330,155,0,2521,930,0,VACSI
2021-04-06,2021,14,REG,,,9.25,3.6,0.0,614,266,0,3135,1196,0,VACSI
2021-04-13,2021,15,REG,,,11.05,4.55,0.0,585,312,0,3720,1508,0,VACSI
2021-04-20,2021,16,REG,,,17.950000000000003,5.9,0.0,1929,466,0,5649,1974,0,VACSI
2021-04-27,2021,17,REG,,,25.1,7.15,0.0,1340,335,0,6989,2309,0,VACSI
2021-05-04,2021,18,REG,,,31.599999999999998,8.65,0.0,1359,575,0,8348,2884,0,VACSI
2021-05-11,2021,19,REG,,,33.15,10.35,0.0,698,462,0,9046,3346,0,VACSI
2021-05-18,2021,20,REG,,,34.75,11.4,0.0,585,295,0,9631,3641,0,VACSI
2021-05-25,2021,21,REG,,,36.75,18.35,0.0,763,2089,0,10394,5730,0,VACSI
2021-06-01,2021,22,REG,,,39.6,27.099999999999998,0.0,883,1157,0,11277,6887,0,VACSI
2021-06-08,2021,23,REG,,,41.400000000000006,28.299999999999997,0.0,692,577,0,11969,7464,0,VACSI
2021-06-15,2021,24,REG,,,42.8,29.9,0.0,694,810,0,12663,8274,0,VACSI
2021-06-22,2021,25,REG,,,44.95,32.05,0.0,455,623,0,13118,8897,0,VACSI
2021-06-29,2021,26,REG,,,46.25,33.9,0.0,482,794,0,13600,9691,0,VACSI
2021-07-06,2021,27,REG,,,48.0,36.3,0.0,494,688,0,14094,10379,0,VACSI
2021-07-13,2021,28,REG,,,49.6,38.3,0.0,658,810,0,14752,11189,0,VACSI
2021-07-20,2021,29,REG,,,51.55,40.45,0.0,627,662,0,15379,11851,0,VACSI
2021-07-27,2021,30,REG,,,53.5,42.45,0.0,674,753,0,16053,12604,0,VACSI
2021-08-03,2021,31,REG,,,55.5,44.15,0.0,629,640,0,16682,13244,0,VACSI
2021-08-10,2021,32,REG,,,57.75,45.95,0.0,709,674,0,17391,13918,0,VACSI
2021-08-17,2021,33,REG,,,59.15,47.7,0.0,376,503,0,17767,14421,0,VACSI
2021-08-24,2021,34,REG,,,60.400000000000006,49.5,0.0,326,578,1,18093,14999,1,VACSI
2021-08-31,2021,35,REG,,,61.55,51.4,0.05,357,606,24,18450,15605,25,VACSI
2021-09-07,2021,36,REG,,,62.650000000000006,52.95,0.25,349,439,46,18799,16044,71,VACSI
2021-09-14,2021,37,REG,,,63.650000000000006,54.300000000000004,0.35,212,365,36,19011,16409,107,VACSI
2021-09-21,2021,38,REG,,,64.15,55.349999999999994,0.55,152,323,41,19163,16732,148,VACSI
2021-09-28,2021,39,REG,,,64.69999999999999,56.349999999999994,0.6,225,278,38,19388,17010,186,VACSI
2021-10-05,2021,40,REG,,,65.35,57.35,0.85,192,219,59,19580,17229,245,VACSI
2021-10-12,2021,41,REG,,,65.94999999999999,58.05,1.15,222,211,80,19802,17440,325,VACSI
2021-10-19,2021,42,REG,,,66.55,58.699999999999996,1.4,217,211,76,20019,17651,401,VACSI
2021-10-26,2021,43,REG,,,67.05,59.35,1.75,178,216,101,20197,17867,502,VACSI
2021-11-02,2021,44,REG,,,67.45,59.8,1.9,196,228,103,20393,18095,605,VACSI
2021-11-09,2021,45,REG,,,67.9,60.45,2.35,168,240,190,20561,18335,795,VACSI
2021-11-16,2021,46,REG,,,68.2,61.05,2.95,127,197,221,20688,18532,1016,VACSI
2021-11-23,2021,47,REG,,,68.5,61.6,4.05,118,216,420,20806,18748,1436,VACSI
2021-11-30,2021,48,REG,,,68.85,62.3,6.800000000000001,116,220,910,20922,18968,2346,VACSI
2021-12-07,2021,49,REG,,,69.3,62.949999999999996,10.6,152,243,1098,21074,19211,3444,VACSI
2021-12-14,2021,50,REG,,,69.65,63.650000000000006,14.600000000000001,102,223,903,21176,19434,4347,VACSI
2021-12-21,2021,51,REG,,,69.9,64.35,17.8,110,232,808,21286,19666,5155,VACSI
2021-12-28,2021,52,REG,,,70.25,65.25,20.5,131,208,721,21417,19874,5876,VACSI
2022-01-04,2022,1,REG,,,70.65,65.94999999999999,23.700000000000003,187,270,1230,21604,20144,7106,VACSI
2022-01-11,2022,2,REG,,,71.4,67.25,31.1,244,332,1556,21848,20476,8662,VACSI
2022-01-18,2022,3,REG,,,71.9,68.1,33.75,139,209,517,21987,20685,9179,VACSI
2022-01-25,2022,4,REG,,,72.05,68.35,34.6,21,24,88,22008,20709,9267,VACSI
